ba đình|ba dinh
hoàn kiếm|hoan kiem
tây hồ|tay ho
long biên|long bien
cầu giấy|cau giay
đống đa|dong da
hai bà trưng|hai ba trung
hoàng mai|hoang mai
thanh xuân|thanh xuan
sóc sơn|soc son
đông anh|dong anh
gia lâm|gia lam
nam từ liêm|nam tu liem
thanh trì|thanh tri
bắc từ liêm|bac tu liem
hà giang|ha giang
đồng văn|dong van
mèo vạc|meo vac
yên minh|yen minh
quản bạ|quan ba
vị xuyên|vi xuyen
bắc mê|bac me
hoàng su phì|hoang su phi
xín mần|xin man
bắc quang|bac quang
quang bình|quang binh
cao bằng|cao bang
bảo lâm|bao lam
bảo lạc|bao lac
hà quảng|ha quang
trùng khánh|trung khanh
hạ lang|ha lang
quảng hòa|quang hoa
hoà an|hoa an
nguyên bình|nguyen binh
thạch an|thach an
bắc kạn|bac kan
pác nặm|pac nam
ba bể|ba be
ngân sơn|ngan son
bạch thông|bach thong
chợ đồn|cho don
chợ mới|cho moi
na rì|na ri
tuyên quang|tuyen quang
lâm bình|lam binh
na hang
chiêm hóa|chiem hoa
hàm yên|ham yen
yên sơn|yen son
sơn dương|son duong
lào cai|lao cai
bát xát|bat xat
mường khương|muong khuong
si ma cai
bắc hà|bac ha
bảo thắng|bao thang
bảo yên|bao yen
sa pa
văn bàn|van ban
điện biên phủ|dien bien phu
mường lay|muong lay
mường nhé|muong nhe
mường chà|muong cha
tủa chùa|tua chua
tuần giáo|tuan giao
điện biên|dien bien
điện biên đông|dien bien dong
mường ảng|muong ang
nậm pồ|nam po
lai châu|lai chau
tam đường|tam duong
mường tè|muong te
sìn hồ|sin ho
phong thổ|phong tho
than uyên|than uyen
tân uyên|tan uyen
nậm nhùn|nam nhun
sơn la|son la
quỳnh nhai|quynh nhai
thuận châu|thuan chau
mường la|muong la
bắc yên|bac yen
phù yên|phu yen
mộc châu|moc chau
yên châu|yen chau
mai sơn|mai son
sông mã|song ma
sốp cộp|sop cop
vân hồ|van ho
yên bái|yen bai
nghĩa lộ|nghia lo
lục yên|luc yen
văn yên|van yen
mù căng chải|mu cang chai
trấn yên|tran yen
trạm tấu|tram tau
văn chấn|van chan
yên bình|yen binh
hòa bình|hoa binh
đà bắc|da bac
lương sơn|luong son
kim bôi|kim boi
cao phong
tân lạc|tan lac
mai châu|mai chau
lạc sơn|lac son
yên thủy|yen thuy
lạc thủy|lac thuy
thái nguyên|thai nguyen
sông công|song cong
định hóa|dinh hoa
phú lương|phu luong
đồng hỷ|dong hy
võ nhai|vo nhai
đại từ|dai tu
phổ yên|pho yen
phú bình|phu binh
lạng sơn|lang son
tràng định|trang dinh
bình gia|binh gia
văn lãng|van lang
cao lộc|cao loc
văn quan|van quan
bắc sơn|bac son
hữu lũng|huu lung
chi lăng|chi lang
lộc bình|loc binh
đình lập|dinh lap
hạ long|ha long
móng cái|mong cai
cẩm phả|cam pha
uông bí|uong bi
bình liêu|binh lieu
tiên yên|tien yen
đầm hà|dam ha
hải hà|hai ha
ba chẽ|ba che
vân đồn|van don
đông triều|dong trieu
quảng yên|quang yen
cô tô|co to
bắc giang|bac giang
yên thế|yen the
tân yên|tan yen
lạng giang|lang giang
lục nam|luc nam
lục ngạn|luc ngan
sơn động|son dong
yên dũng|yen dung
việt yên|viet yen
hiệp hòa|hiep hoa
việt trì|viet tri
phú thọ|phu tho
đoan hùng|doan hung
hạ hoà|ha hoa
thanh ba
phù ninh|phu ninh
yên lập|yen lap
cẩm khê|cam khe
tam nông|tam nong
lâm thao|lam thao
thanh sơn|thanh son
thanh thuỷ|thanh thuy
tân sơn|tan son
vĩnh yên|vinh yen
phúc yên|phuc yen
lập thạch|lap thach
tam dương|tam duong
tam đảo|tam dao
bình xuyên|binh xuyen
mê linh|me linh
yên lạc|yen lac
vĩnh tường|vinh tuong
sông lô|song lo
bắc ninh|bac ninh
yên phong|yen phong
quế võ|que vo
tiên du|tien du
từ sơn|tu son
thuận thành|thuan thanh
gia bình|gia binh
lương tài|luong tai
hà đông|ha dong
sơn tây|son tay
ba vì|ba vi
phúc thọ|phuc tho
đan phượng|dan phuong
hoài đức|hoai duc
quốc oai|quoc oai
thạch thất|thach that
chương mỹ|chuong my
thanh oai
thường tín|thuong tin
phú xuyên|phu xuyen
ứng hòa|ung hoa
mỹ đức|my duc
hải dương|hai duong
chí linh|chi linh
nam sách|nam sach
kinh môn|kinh mon
kim thành|kim thanh
thanh hà|thanh ha
cẩm giàng|cam giang
bình giang|binh giang
gia lộc|gia loc
tứ kỳ|tu ky
ninh giang
thanh miện|thanh mien
hồng bàng|hong bang
ngô quyền|ngo quyen
lê chân|le chan
hải an|hai an
kiến an|kien an
đồ sơn|do son
dương kinh|duong kinh
thuỷ nguyên|thuy nguyen
an dương|an duong
an lão|an lao
kiến thuỵ|kien thuy
tiên lãng|tien lang
vĩnh bảo|vinh bao
cát hải|cat hai
bạch long vĩ|bach long vi
hưng yên|hung yen
văn lâm|van lam
văn giang|van giang
yên mỹ|yen my
mỹ hào|my hao
ân thi|an thi
khoái châu|khoai chau
kim động|kim dong
tiên lữ|tien lu
phù cừ|phu cu
thái bình|thai binh
quỳnh phụ|quynh phu
hưng hà|hung ha
đông hưng|dong hung
thái thụy|thai thuy
tiền hải|tien hai
kiến xương|kien xuong
vũ thư|vu thu
phủ lý|phu ly
duy tiên|duy tien
kim bảng|kim bang
thanh liêm|thanh liem
bình lục|binh luc
lý nhân|ly nhan
nam định|nam dinh
mỹ lộc|my loc
vụ bản|vu ban
ý yên|y yen
nghĩa hưng|nghia hung
nam trực|nam truc
trực ninh|truc ninh
xuân trường|xuan truong
giao thủy|giao thuy
hải hậu|hai hau
ninh bình|ninh binh
tam điệp|tam diep
nho quan
gia viễn|gia vien
hoa lư|hoa lu
yên khánh|yen khanh
kim sơn|kim son
yên mô|yen mo
thanh hóa|thanh hoa
bỉm sơn|bim son
sầm sơn|sam son
mường lát|muong lat
quan hóa|quan hoa
bá thước|ba thuoc
quan sơn|quan son
lang chánh|lang chanh
ngọc lặc|ngoc lac
cẩm thủy|cam thuy
thạch thành|thach thanh
hà trung|ha trung
vĩnh lộc|vinh loc
yên định|yen dinh
thọ xuân|tho xuan
thường xuân|thuong xuan
triệu sơn|trieu son
thiệu hóa|thieu hoa
hoằng hóa|hoang hoa
hậu lộc|hau loc
nga sơn|nga son
như xuân|nhu xuan
như thanh|nhu thanh
nông cống|nong cong
đông sơn|dong son
quảng xương|quang xuong
nghi sơn|nghi son
cửa lò|cua lo
vinh
thái hoà|thai hoa
quế phong|que phong
quỳ châu|quy chau
kỳ sơn|ky son
tương dương|tuong duong
nghĩa đàn|nghia dan
quỳ hợp|quy hop
quỳnh lưu|quynh luu
con cuông|con cuong
tân kỳ|tan ky
anh sơn|anh son
diễn châu|dien chau
yên thành|yen thanh
đô lương|do luong
thanh chương|thanh chuong
nghi lộc|nghi loc
nam đàn|nam dan
hưng nguyên|hung nguyen
hoàng mai|hoang mai
hà tĩnh|ha tinh
hồng lĩnh|hong linh
hương sơn|huong son
đức thọ|duc tho
vũ quang|vu quang
nghi xuân|nghi xuan
can lộc|can loc
hương khê|huong khe
thạch hà|thach ha
cẩm xuyên|cam xuyen
kỳ anh|ky anh
lộc hà|loc ha
kỳ anh|ky anh
đồng hới|dong hoi
minh hóa|minh hoa
tuyên hóa|tuyen hoa
quảng trạch|quang trach
bố trạch|bo trach
quảng ninh|quang ninh
lệ thủy|le thuy
ba đồn|ba don
đông hà|dong ha
quảng trị|quang tri
vĩnh linh|vinh linh
hướng hóa|huong hoa
gio linh
đa krông|da krong
cam lộ|cam lo
triệu phong|trieu phong
hải lăng|hai lang
cồn cỏ|con co
phong điền|phong dien
quảng điền|quang dien
phú vang|phu vang
hương thủy|huong thuy
hương trà|huong tra
a lưới|a luoi
phú lộc|phu loc
nam đông|nam dong
liên chiểu|lien chieu
thanh khê|thanh khe
hải châu|hai chau
sơn trà|son tra
ngũ hành sơn|ngu hanh son
cẩm lệ|cam le
hòa vang|hoa vang
hoàng sa|hoang sa
tam kỳ|tam ky
hội an|hoi an
tây giang|tay giang
đông giang|dong giang
đại lộc|dai loc
điện bàn|dien ban
duy xuyên|duy xuyen
quế sơn|que son
nam giang
phước sơn|phuoc son
hiệp đức|hiep duc
thăng bình|thang binh
tiên phước|tien phuoc
bắc trà my|bac tra my
nam trà my|nam tra my
núi thành|nui thanh
phú ninh|phu ninh
nông sơn|nong son
quảng ngãi|quang ngai
bình sơn|binh son
trà bồng|tra bong
sơn tịnh|son tinh
tư nghĩa|tu nghia
sơn hà|son ha
sơn tây|son tay
minh long
nghĩa hành|nghia hanh
mộ đức|mo duc
đức phổ|duc pho
ba tơ|ba to
lý sơn|ly son
quy nhơn|quy nhon
an lão|an lao
hoài nhơn|hoai nhon
hoài ân|hoai an
phù mỹ|phu my
vĩnh thạnh|vinh thanh
tây sơn|tay son
phù cát|phu cat
an nhơn|an nhon
tuy phước|tuy phuoc
vân canh|van canh
tuy hoà|tuy hoa
sông cầu|song cau
đồng xuân|dong xuan
tuy an
sơn hòa|son hoa
sông hinh|song hinh
tây hoà|tay hoa
phú hoà|phu hoa
đông hòa|dong hoa
nha trang
cam ranh
cam lâm|cam lam
vạn ninh|van ninh
ninh hòa|ninh hoa
khánh vĩnh|khanh vinh
diên khánh|dien khanh
khánh sơn|khanh son
trường sa|truong sa
phan rang-tháp chàm|phan rang thap cham
bác ái|bac ai
ninh sơn|ninh son
ninh hải|ninh hai
ninh phước|ninh phuoc
thuận bắc|thuan bac
thuận nam|thuan nam
phan thiết|phan thiet
la gi
tuy phong
bắc bình|bac binh
hàm thuận bắc|ham thuan bac
hàm thuận nam|ham thuan nam
tánh linh|tanh linh
đức linh|duc linh
hàm tân|ham tan
phú quí|phu qui
kon tum
đắk glei|dak glei
ngọc hồi|ngoc hoi
đắk tô|dak to
kon plông|kon plong
kon rẫy|kon ray
đắk hà|dak ha
sa thầy|sa thay
tu mơ rông|tu mo rong
ia h' drai|ia h  drai
an khê|an khe
pleiku
ayun pa
đăk đoa|dak doa
chư păh|chu pah
ia grai
mang yang
kông chro|kong chro
đức cơ|duc co
chư prông|chu prong
chư sê|chu se
đăk pơ|dak po
ia pa
krông pa|krong pa
phú thiện|phu thien
chư pưh|chu puh
buôn ma thuột|buon ma thuot
buôn hồ|buon ho
ea h'leo|ea h leo
ea súp|ea sup
buôn đôn|buon don
cư m'gar|cu m gar
krông búk|krong buk
krông năng|krong nang
ea kar
krông bông|krong bong
krông pắc|krong pac
krông a na|krong a na
cư kuin|cu kuin
gia nghĩa|gia nghia
đăk glong|dak glong
cư jút|cu jut
đắk mil|dak mil
krông nô|krong no
đắk song|dak song
đắk r'lấp|dak r lap
tuy đức|tuy duc
đà lạt|da lat
bảo lộc|bao loc
đam rông|dam rong
lạc dương|lac duong
lâm hà|lam ha
đơn dương|don duong
đức trọng|duc trong
di linh
bảo lâm|bao lam
đạ huoai|da huoai
đạ tẻh|da teh
cát tiên|cat tien
phước long|phuoc long
đồng xoài|dong xoai
bình long|binh long
bù gia mập|bu gia map
lộc ninh|loc ninh
bù đốp|bu dop
hớn quản|hon quan
đồng phú|dong phu
bù đăng|bu dang
chơn thành|chon thanh
phú riềng|phu rieng
tây ninh|tay ninh
tân biên|tan bien
tân châu|tan chau
dương minh châu|duong minh chau
châu thành|chau thanh
hòa thành|hoa thanh
gò dầu|go dau
bến cầu|ben cau
trảng bàng|trang bang
thủ dầu một|thu dau mot
bàu bàng|bau bang
dầu tiếng|dau tieng
bến cát|ben cat
phú giáo|phu giao
tân uyên|tan uyen
dĩ an|di an
thuận an|thuan an
bắc tân uyên|bac tan uyen
biên hòa|bien hoa
long khánh|long khanh
tân phú|tan phu
vĩnh cửu|vinh cuu
định quán|dinh quan
trảng bom|trang bom
thống nhất|thong nhat
cẩm mỹ|cam my
long thành|long thanh
xuân lộc|xuan loc
nhơn trạch|nhon trach
vũng tàu|vung tau
bà rịa|ba ria
châu đức|chau duc
xuyên mộc|xuyen moc
long điền|long dien
đất đỏ|dat do
phú mỹ|phu my
côn đảo|con dao
quận 1|quan 1|q.1|q. 1|q1|q 1
quận 2|quan 2|q.2|q. 2|q2|q 2
quận 9|quan 9|q.9|q. 9|q9|q 9
quận 12|quan 12|q.12|q. 12|q12|q 12
gò vấp|go vap
bình thạnh|binh thanh
tân bình|tan binh
tân phú|tan phu
phú nhuận|phu nhuan
thủ đức|thu duc
quận 3|quan 3|q.3|q. 3|q3|q 3
quận 10|quan 10|q.10|q. 10|q10|q 10
quận 11|quan 11|q.11|q. 11|q11|q 11
quận 4|quan 4|q.4|q. 4|q4|q 4
quận 5|quan 5|q.5|q. 5|q5|q 5
quận 6|quan 6|q.6|q. 6|q6|q 6
quận 8|quan 8|q.8|q. 8|q8|q 8
bình tân|binh tan
quận 7|quan 7|q.7|q. 7|q7|q 7
củ chi|cu chi
hóc môn|hoc mon
bình chánh|binh chanh
nhà bè|nha be
cần giờ|can gio
tân an|tan an
kiến tường|kien tuong
tân hưng|tan hung
vĩnh hưng|vinh hung
mộc hóa|moc hoa
tân thạnh|tan thanh
thạnh hóa|thanh hoa
đức huệ|duc hue
đức hòa|duc hoa
bến lức|ben luc
thủ thừa|thu thua
tân trụ|tan tru
cần đước|can duoc
cần giuộc|can giuoc
châu thành|chau thanh
mỹ tho|my tho
gò công|go cong
cai lậy|cai lay
tân phước|tan phuoc
cái bè|cai be
cai lậy|cai lay
châu thành|chau thanh
chợ gạo|cho gao
gò công tây|go cong tay
gò công đông|go cong dong
tân phú đông|tan phu dong
bến tre|ben tre
châu thành|chau thanh
chợ lách|cho lach
mỏ cày nam|mo cay nam
giồng trôm|giong trom
bình đại|binh dai
ba tri
thạnh phú|thanh phu
mỏ cày bắc|mo cay bac
trà vinh|tra vinh
càng long|cang long
cầu kè|cau ke
tiểu cần|tieu can
châu thành|chau thanh
cầu ngang|cau ngang
trà cú|tra cu
duyên hải|duyen hai
duyên hải|duyen hai
vĩnh long|vinh long
long hồ|long ho
mang thít|mang thit
vũng liêm|vung liem
tam bình|tam binh
bình minh|binh minh
trà ôn|tra on
bình tân|binh tan
cao lãnh|cao lanh
sa đéc|sa dec
hồng ngự|hong ngu
tân hồng|tan hong
hồng ngự|hong ngu
tam nông|tam nong
tháp mười|thap muoi
cao lãnh|cao lanh
thanh bình|thanh binh
lấp vò|lap vo
lai vung
châu thành|chau thanh
long xuyên|long xuyen
châu đốc|chau doc
an phú|an phu
tân châu|tan chau
phú tân|phu tan
châu phú|chau phu
tịnh biên|tinh bien
tri tôn|tri ton
châu thành|chau thanh
chợ mới|cho moi
thoại sơn|thoai son
rạch giá|rach gia
hà tiên|ha tien
kiên lương|kien luong
hòn đất|hon dat
tân hiệp|tan hiep
châu thành|chau thanh
giồng riềng|giong rieng
gò quao|go quao
an biên|an bien
an minh
vĩnh thuận|vinh thuan
phú quốc|phu quoc
kiên hải|kien hai
u minh thượng|u minh thuong
giang thành|giang thanh
ninh kiều|ninh kieu
ô môn|o mon
bình thủy|bình thuỷ|binh thuy
cái răng|cai rang
thốt nốt|thot not
vĩnh thạnh|vinh thanh
cờ đỏ|co do
phong điền|phong dien
thới lai|thoi lai
vị thanh|vi thanh
ngã bảy|nga bay
châu thành a|chau thanh a
châu thành|chau thanh
phụng hiệp|phung hiep
vị thuỷ|vi thuy
long mỹ|long my
long mỹ|long my
sóc trăng|soc trang
châu thành|chau thanh
kế sách|ke sach
mỹ tú|my tu
cù lao dung|cu lao dung
long phú|long phu
mỹ xuyên|my xuyen
ngã năm|nga nam
thạnh trị|thanh tri
vĩnh châu|vinh chau
trần đề|tran de
bạc liêu|bac lieu
hồng dân|hong dan
phước long|phuoc long
vĩnh lợi|vinh loi
giá rai|gia rai
đông hải|dong hai
hoà bình|hoa binh
cà mau|ca mau
u minh
thới bình|thoi binh
trần văn thời|tran van thoi
cái nước|cai nuoc
đầm dơi|dam doi
năm căn|nam can
phú tân|phu tan
ngọc hiển|ngoc hien