phúc xá|phuc xa
trúc bạch|truc bach
vĩnh phúc|vinh phuc
cống vị|cong vi
liễu giai|lieu giai
nguyễn trung trực|nguyen trung truc
quán thánh|quan thanh
ngọc hà|ngoc ha
điện biên|dien bien
đội cấn|doi can
ngọc khánh|ngoc khanh
kim mã|kim ma
giảng võ|giang vo
thành công|thanh cong
phúc tân|phuc tan
đồng xuân|dong xuan
hàng mã|hang ma
hàng buồm|hang buom
hàng đào|hang dao
hàng bồ|hang bo
cửa đông|cua dong
lý thái tổ|ly thai to
hàng bạc|hang bac
hàng gai|hang gai
chương dương|chuong duong
hàng trống|hang trong
cửa nam|cua nam
hàng bông|hang bong
tràng tiền|trang tien
trần hưng đạo|tran hung dao
phan chu trinh
hàng bài|hang bai
phú thượng|phu thuong
nhật tân|nhat tan
tứ liên|tu lien
quảng an|quang an
xuân la|xuan la
yên phụ|yen phu
thụy khuê|thuy khue
thượng thanh|thuong thanh
ngọc thụy|ngoc thuy
giang biên|giang bien
đức giang|duc giang
việt hưng|viet hung
gia thụy|gia thuy
ngọc lâm|ngoc lam
phúc lợi|phuc loi
bồ đề|bo de
sài đồng|sai dong
long biên|long bien
thạch bàn|thach ban
phúc đồng|phuc dong
cự khối|cu khoi
nghĩa đô|nghia do
nghĩa tân|nghia tan
mai dịch|mai dich
dịch vọng|dich vong
dịch vọng hậu|dich vong hau
quan hoa
yên hoà|yen hoa
trung hoà|trung hoa
cát linh|cat linh
văn miếu|van mieu
quốc tử giám|quoc tu giam
láng thượng|lang thuong
ô chợ dừa|o cho dua
văn chương|van chuong
hàng bột|hang bot
láng hạ|lang ha
khâm thiên|kham thien
thổ quan|tho quan
nam đồng|nam dong
trung phụng|trung phung
quang trung
trung liệt|trung liet
phương liên|phuong lien
thịnh quang|thinh quang
trung tự|trung tu
kim liên|kim lien
phương mai|phuong mai
ngã tư sở|nga tu so
khương thượng|khuong thuong
nguyễn du|nguyen du
bạch đằng|bach dang
phạm đình hổ|pham dinh ho
lê đại hành|le dai hanh
đồng nhân|dong nhan
phố huế|pho hue
đống mác|dong mac
thanh lương|thanh luong
thanh nhàn|thanh nhan
cầu dền|cau den
bách khoa|bach khoa
đồng tâm|dong tam
vĩnh tuy|vinh tuy
bạch mai|bach mai
quỳnh mai|quynh mai
quỳnh lôi|quynh loi
minh khai
trương định|truong dinh
thanh trì|thanh tri
vĩnh hưng|vinh hung
định công|dinh cong
mai động|mai dong
tương mai|tuong mai
đại kim|dai kim
tân mai|tan mai
hoàng văn thụ|hoang van thu
giáp bát|giap bat
lĩnh nam|linh nam
thịnh liệt|thinh liet
trần phú|tran phu
hoàng liệt|hoang liet
yên sở|yen so
nhân chính|nhan chinh
thượng đình|thuong dinh
khương trung|khuong trung
khương mai|khuong mai
thanh xuân trung|thanh xuan trung
phương liệt|phuong liet
hạ đình|ha dinh
khương đình|khuong dinh
thanh xuân bắc|thanh xuan bac
thanh xuân nam|thanh xuan nam
kim giang
sóc sơn|soc son
bắc sơn|bac son
minh trí|minh tri
hồng kỳ|hong ky
nam sơn|nam son
trung giã|trung gia
tân hưng|tan hung
minh phú|minh phu
phù linh|phu linh
bắc phú|bac phu
tân minh|tan minh
quang tiến|quang tien
hiền ninh|hien ninh
tân dân|tan dan
tiên dược|tien duoc
việt long|viet long
xuân giang|xuan giang
mai đình|mai dinh
đức hoà|duc hoa
thanh xuân|thanh xuan
đông xuân|dong xuan
kim lũ|kim lu
phú cường|phu cuong
phú minh|phu minh
phù lỗ|phu lo
xuân thu|xuan thu
đông anh|dong anh
xuân nộn|xuan non
thuỵ lâm|thuy lam
bắc hồng|bac hong
nguyên khê|nguyen khe
nam hồng|nam hong
tiên dương|tien duong
vân hà|van ha
uy nỗ|uy no
vân nội|van noi
liên hà|lien ha
việt hùng|viet hung
kim nỗ|kim no
kim chung
dục tú|duc tu
đại mạch|dai mach
vĩnh ngọc|vinh ngoc
cổ loa|co loa
hải bối|hai boi
xuân canh|xuan canh
võng la|vong la
tàm xá|tam xa
mai lâm|mai lam
đông hội|dong hoi
yên viên|yen vien
yên thường|yen thuong
ninh hiệp|ninh hiep
đình xuyên|dinh xuyen
dương hà|duong ha
phù đổng|phu dong
trung mầu|trung mau
lệ chi|le chi
cổ bi|co bi
đặng xá|dang xa
phú thị|phu thi
kim sơn|kim son
trâu quỳ|trau quy
dương quang|duong quang
dương xá|duong xa
đông dư|dong du
đa tốn|da ton
kiêu kỵ|kieu ky
bát tràng|bat trang
kim lan
văn đức|van duc
cầu diễn|cau dien
thượng cát|thuong cat
liên mạc|lien mac
đông ngạc|dong ngac
đức thắng|duc thang
thụy phương|thuy phuong
tây tựu|tay tuu
xuân đỉnh|xuan dinh
xuân tảo|xuan tao
cổ nhuế 1|co nhue 1
cổ nhuế 2|co nhue 2|co nhue|cổ nhuế
phú diễn|phu dien
phúc diễn|phuc dien
xuân phương|xuan phuong
phương canh|phuong canh
mỹ đình 1|my dinh 1
mỹ đình 2|my dinh 2
tây mỗ|tay mo
mễ trì|me tri
phú đô|phu do
đại mỗ|dai mo
trung văn|trung van
văn điển|van dien
tân triều|tan trieu
thanh liệt|thanh liet
tả thanh oai|ta thanh oai
hữu hoà|huu hoa
tam hiệp|tam hiep
tứ hiệp|tu hiep
yên mỹ|yen my
vĩnh quỳnh|vinh quynh
ngũ hiệp|ngu hiep
duyên hà|duyen ha
ngọc hồi|ngoc hoi
vạn phúc|van phuc
đại áng|dai ang
liên ninh|lien ninh
đông mỹ|dong my
nguyễn trãi|nguyen trai
ngọc đường|ngoc duong
kim thạch|kim thach
phú linh|phu linh
kim linh
phó bảng|pho bang
lũng cú|lung cu
má lé|ma le
đồng văn|dong van
lũng táo|lung tao
phố là|pho la
thài phìn tủng|thai phin tung
sủng là|sung la
xà phìn|xa phin
tả phìn|ta phin
tả lủng|ta lung
phố cáo|pho cao
sính lủng|sinh lung
sảng tủng|sang tung
lũng thầu|lung thau
hố quáng phìn|ho quang phin
vần chải|van chai
lũng phìn|lung phin
sủng trái|sung trai
mèo vạc|meo vac
thượng phùng|thuong phung
pải lủng|pai lung
xín cái|xin cai
pả vi|pa vi
giàng chu phìn|giang chu phin
sủng trà|sung tra
sủng máng|sung mang
sơn vĩ|son vi
cán chu phìn|can chu phin
lũng pù|lung pu
lũng chinh|lung chinh
tát ngà|tat nga
nậm ban|nam ban
khâu vai|khau vai
niêm tòng|niem tong
niêm sơn|niem son
yên minh|yen minh
thắng mố|thang mo
phú lũng|phu lung
sủng tráng|sung trang
bạch đích|bach dich
na khê|na khe
sủng thài|sung thai
hữu vinh|huu vinh
lao và chải|lao va chai
mậu duệ|mau due
đông minh|dong minh
mậu long|mau long
ngam la
ngọc long|ngoc long
đường thượng|duong thuong
lũng hồ|lung ho
du tiến|du tien
du già|du gia
tam sơn|tam son
bát đại sơn|bat dai son
nghĩa thuận|nghia thuan
cán tỷ|can ty
cao mã pờ|cao ma po
thanh vân|thanh van
tùng vài|tung vai
đông hà|dong ha
quản bạ|quan ba
lùng tám|lung tam
quyết tiến|quyet tien
tả ván|ta van
thái an|thai an
vị xuyên|vi xuyen
nông trường việt lâm|nong truong viet lam
minh tân|minh tan
thuận hoà|thuan hoa
tùng bá|tung ba
thanh thủy|thanh thuy
thanh đức|thanh duc
phong quang
xín chải|xin chai
phương tiến|phuong tien
lao chải|lao chai
phương độ|phuong do
phương thiện|phuong thien
cao bồ|cao bo
đạo đức|dao duc
thượng sơn|thuong son
linh hồ|linh ho
quảng ngần|quang ngan
việt lâm|viet lam
ngọc linh|ngoc linh
ngọc minh|ngoc minh
bạch ngọc|bach ngoc
trung thành|trung thanh
minh sơn|minh son
giáp trung|giap trung
yên định|yen dinh
yên phú|yen phu
minh ngọc|minh ngoc
yên phong|yen phong
lạc nông|lac nong
phú nam|phu nam
yên cường|yen cuong
thượng tân|thuong tan
đường âm|duong am
đường hồng|duong hong
phiêng luông|phieng luong
vinh quang
bản máy|ban may
thàng tín|thang tin
thèn chu phìn|then chu phin
pố lồ|po lo
bản phùng|ban phung
túng sán|tung san
chiến phố|chien pho
đản ván|dan van
tụ nhân|tu nhan
tân tiến|tan tien
nàng đôn|nang don
pờ ly ngài|po ly ngai
sán xả hồ|san xa ho
bản luốc|ban luoc
ngàm đăng vài|ngam dang vai
bản nhùng|ban nhung
tả sử choóng|ta su choong
nậm dịch|nam dich
hồ thầu|ho thau
nậm tỵ|nam ty
thông nguyên|thong nguyen
nậm khòa|nam khoa
cốc pài|coc pai
nàn xỉn|nan xin
bản díu|ban diu
chí cà|chi ca
xín mần|xin man
thèn phàng|then phang
trung thịnh|trung thinh
pà vầy sủ|pa vay su
cốc rế|coc re
thu tà|thu ta
nàn ma|nan ma
tả nhìu|ta nhiu
bản ngò|ban ngo
chế là|che la
nấm dẩn|nam dan
quảng nguyên|quang nguyen
nà chì|na chi
khuôn lùng|khuon lung
việt quang|viet quang
tân lập|tan lap
tân thành|tan thanh
đồng tiến|dong tien
tân quang|tan quang
thượng bình|thuong binh
hữu sản|huu san
kim ngọc|kim ngoc
việt vinh|viet vinh
bằng hành|bang hanh
quang minh
liên hiệp|lien hiep
vô điếm|vo diem
việt hồng|viet hong
hùng an|hung an
đức xuân|duc xuan
tiên kiều|tien kieu
vĩnh hảo|vinh hao
đồng yên|dong yen
đông thành|dong thanh
xuân minh|xuan minh
tiên nguyên|tien nguyen
tân nam|tan nam
bản rịa|ban ria
yên thành|yen thanh
yên bình|yen binh
tân trịnh|tan trinh
tân bắc|tan bac
bằng lang|bang lang
yên hà|yen ha
hương sơn|huong son
nà khương|na khuong
tiên yên|tien yen
vĩ thượng|vi thuong
sông hiến|song hien
sông bằng|song bang
hợp giang|hop giang
tân giang|tan giang
ngọc xuân|ngoc xuan
đề thám|de tham
hoà chung|hoa chung
duyệt trung|duyet trung
pác miầu|pac miau
đức hạnh|duc hanh
lý bôn|ly bon
nam cao
nam quang
vĩnh quang|vinh quang
quảng lâm|quang lam
thạch lâm|thach lam
vĩnh phong|vinh phong
mông ân|mong an
thái học|thai hoc
thái sơn|thai son
yên thổ|yen tho
bảo lạc|bao lac
cốc pàng|coc pang
thượng hà|thuong ha
cô ba|co ba
bảo toàn|bao toan
khánh xuân|khanh xuan
xuân trường|xuan truong
hồng trị|hong tri
kim cúc|kim cuc
phan thanh
hồng an|hong an
hưng đạo|hung dao
hưng thịnh|hung thinh
huy giáp|huy giap
đình phùng|dinh phung
sơn lập|son lap
sơn lộ|son lo
thông nông|thong nong
cần yên|can yen
cần nông|can nong
lương thông|luong thong
đa thông|da thong
ngọc động|ngoc dong
yên sơn|yen son
lương can|luong can
thanh long
xuân hòa|xuan hoa
lũng nặm|lung nam
trường hà|truong ha
cải viên|cai vien
nội thôn|noi thon
tổng cọt|tong cot
sóc hà|soc ha
thượng thôn|thuong thon
hồng sỹ|hong sy
quý quân|quy quan
mã ba|ma ba
ngọc đào|ngoc dao
trà lĩnh|tra linh
tri phương|tri phuong
quang hán|quang han
xuân nội|xuan noi
quang vinh
cao chương|cao chuong
quốc toản|quoc toan
trùng khánh|trung khanh
ngọc khê|ngoc khe
ngọc côn|ngoc con
phong nậm|phong nam
đình phong|dinh phong
đàm thuỷ|dam thuy
khâm thành|kham thanh
chí viễn|chi vien
lăng hiếu|lang hieu
phong châu|phong chau
trung phúc|trung phuc
cao thăng|cao thang
đức hồng|duc hong
đoài dương|doai duong
minh long
lý quốc|ly quoc
thắng lợi|thang loi
đồng loan|dong loan
đức quang|duc quang
kim loan
quang long
an lạc|an lac
thanh nhật|thanh nhat
vinh quý|vinh quy
thống nhất|thong nhat
cô ngân|co ngan
thị hoa|thi hoa
quảng uyên|quang uyen
phi hải|phi hai
quảng hưng|quang hung
độc lập|doc lap
cai bộ|cai bo
phúc sen|phuc sen
chí thảo|chi thao
tự do|tu do
hồng quang|hong quang
hạnh phúc|hanh phuc
tà lùng|ta lung
bế văn đàn|be van dan
cách linh|cach linh
đại sơn|dai son
tiên thành|tien thanh
hoà thuận|hoa thuan
mỹ hưng|my hung
nước hai|nuoc hai
dân chủ|dan chu
nam tuấn|nam tuan
đại tiến|dai tien
đức long|duc long
ngũ lão|ngu lao
trương lương|truong luong
hồng việt|hong viet
hoàng tung|hoang tung
nguyễn huệ|nguyen hue
bình dương|binh duong
lê chung|le chung
chu trinh
hồng nam|hong nam
nguyên bình|nguyen binh
tĩnh túc|tinh tuc
yên lạc|yen lac
triệu nguyên|trieu nguyen
ca thành|ca thanh
vũ nông|vu nong
minh tâm|minh tam
thể dục|the duc
mai long
vũ minh|vu minh
hoa thám|hoa tham
quang thành|quang thanh
tam kim
thịnh vượng|thinh vuong
đông khê|dong khe
canh tân|canh tan
kim đồng|kim dong
đức thông|duc thong
thái cường|thai cuong
vân trình|van trinh
thụy hùng|thuy hung
quang trọng|quang trong
trọng con|trong con
lê lai|le lai
lê lợi|le loi
nguyễn thị minh khai|nguyen thi minh khai
sông cầu|song cau
phùng chí kiên|phung chi kien
huyền tụng|huyen tung
nông thượng|nong thuong
xuất hóa|xuat hoa
bằng thành|bang thanh
nhạn môn|nhan mon
bộc bố|boc bo
công bằng|cong bang
giáo hiệu|giao hieu
an thắng|an thang
cổ linh|co linh
nghiên loan|nghien loan
cao tân|cao tan
chợ rã|cho ra
bành trạch|banh trach
phúc lộc|phuc loc
hà hiệu|ha hieu
cao thượng|cao thuong
khang ninh
nam mẫu|nam mau
thượng giáo|thuong giao
địa linh|dia linh
yến dương|yen duong
chu hương|chu huong
quảng khê|quang khe
mỹ phương|my phuong
hoàng trĩ|hoang tri
đồng phúc|dong phuc
nà phặc|na phac
thượng ân|thuong an
bằng vân|bang van
cốc đán|coc dan
đức vân|duc van
vân tùng|van tung
thượng quan|thuong quan
hiệp lực|hiep luc
thuần mang|thuan mang
phủ thông|phu thong
vi hương|vi huong
sĩ bình|si binh
vũ muộn|vu muon
đôn phong|don phong
lục bình|luc binh
tân tú|tan tu
nguyên phúc|nguyen phuc
cao sơn|cao son
quân hà|quan ha
cẩm giàng|cam giang
mỹ thanh|my thanh
dương phong|duong phong
quang thuận|quang thuan
bằng lũng|bang lung
xuân lạc|xuan lac
nam cường|nam cuong
đồng lạc|dong lac
bản thi|ban thi
quảng bạch|quang bach
bằng phúc|bang phuc
yên thịnh|yen thinh
yên thượng|yen thuong
phương viên|phuong vien
ngọc phái|ngoc phai
đồng thắng|dong thang
lương bằng|luong bang
bằng lãng|bang lang
đại sảo|dai sao
nghĩa tá|nghia ta
bình trung|binh trung
tân sơn|tan son
thanh vận|thanh van
mai lạp|mai lap
hoà mục|hoa muc
thanh mai
cao kỳ|cao ky
nông hạ|nong ha
yên cư|yen cu
thanh thịnh|thanh thinh
yên hân|yen han
như cố|nhu co
bình văn|binh van
quảng chu|quang chu
văn vũ|van vu
văn lang|van lang
lương thượng|luong thuong
kim hỷ|kim hy
cường lợi|cuong loi
yến lạc|yen lac
kim lư|kim lu
sơn thành|son thanh
văn minh|van minh
côn minh|con minh
cư lễ|cu le
quang phong
dương sơn|duong son
xuân dương|xuan duong
đổng xá|dong xa
liêm thuỷ|liem thuy
phan thiết|phan thiet
minh xuân|minh xuan
tràng đà|trang da
nông tiến|nong tien
ỷ la|y la
tân hà|tan ha
hưng thành|hung thanh
na hang
sinh long
thượng giáp|thuong giap
phúc yên|phuc yen
thượng nông|thuong nong
xuân lập|xuan lap
côn lôn|con lon
yên hoa|yen hoa
khuôn hà|khuon ha
hồng thái|hong thai
đà vị|da vi
khau tinh
lăng can|lang can
thượng lâm|thuong lam
sơn phú|son phu
năng khả|nang kha
thanh tương|thanh tuong
vĩnh lộc|vinh loc
bình an|binh an
thổ bình|tho binh
phúc sơn|phuc son
minh quang
trung hà|trung ha
tân mỹ|tan my
hà lang|ha lang
hùng mỹ|hung my
yên lập|yen lap
tân an|tan an
bình phú|binh phu
xuân quang|xuan quang
ngọc hội|ngoc hoi
phú bình|phu binh
hòa phú|hoa phu
phúc thịnh|phuc thinh
kiên đài|kien dai
tân thịnh|tan thinh
trung hòa|trung hoa
kim bình|kim binh
hòa an|hoa an
tri phú|tri phu
nhân lý|nhan ly
yên nguyên|yen nguyen
linh phú|linh phu
bình nhân|binh nhan
tân yên|tan yen
yên thuận|yen thuan
bạch xa|bach xa
minh khương|minh khuong
yên lâm|yen lam
minh dân|minh dan
phù lưu|phu luu
minh hương|minh huong
bình xa|binh xa
nhân mục|nhan muc
thành long|thanh long
bằng cốc|bang coc
thái hòa|thai hoa
đức ninh|duc ninh
hùng đức|hung duc
quí quân|qui quan
lực hành|luc hanh
kiến thiết|kien thiet
trung minh
chiêu yên|chieu yen
trung trực|trung truc
xuân vân|xuan van
phúc ninh|phuc ninh
hùng lợi|hung loi
trung sơn|trung son
tứ quận|tu quan
đạo viện|dao vien
tân long|tan long
kim quan
lang quán|lang quan
phú thịnh|phu thinh
công đa|cong da
trung môn|trung mon
chân sơn|chan son
thái bình|thai binh
kim phú|kim phu
tiến bộ|tien bo
an khang
mỹ bằng|my bang
mỹ lâm|my lam
an tường|an tuong
lưỡng vượng|luong vuong
hoàng khai|hoang khai
thái long|thai long
nhữ hán|nhu han
nhữ khê|nhu khe
đội bình|doi binh
sơn dương|son duong
trung yên|trung yen
minh thanh
tân trào|tan trao
vĩnh lợi|vinh loi
thượng ấm|thuong am
bình yên|binh yen
lương thiện|luong thien
tú thịnh|tu thinh
cấp tiến|cap tien
hợp thành|hop thanh
phúc ứng|phuc ung
đông thọ|dong tho
kháng nhật|khang nhat
hợp hòa|hop hoa
quyết thắng|quyet thang
đồng quý|dong quy
tân thanh|tan thanh
vân sơn|van son
văn phú|van phu
chi thiết|chi thiet
đông lợi|dong loi
thiện kế|thien ke
hồng lạc|hong lac
phú lương|phu luong
ninh lai
đại phú|dai phu
sơn nam|son nam
hào phú|hao phu
tam đa|tam da
trường sinh|truong sinh
duyên hải|duyen hai
lào cai|lao cai
cốc lếu|coc leu
kim tân|kim tan
bắc lệnh|bac lenh
pom hán|pom han
xuân tăng|xuan tang
bình minh|binh minh
đồng tuyển|dong tuyen
vạn hoà|van hoa
bắc cường|bac cuong
cam đường|cam duong
tả phời|ta phoi
bát xát|bat xat
a mú sung|a mu sung
nậm chạc|nam chac
a lù|a lu
trịnh tường|trinh tuong
y tý|y ty
cốc mỳ|coc my
dền sáng|den sang
bản vược|ban vuoc
sàng ma sáo|sang ma sao
bản qua|ban qua
mường vi|muong vi
dền thàng|den thang
bản xèo|ban xeo
mường hum|muong hum
trung lèng hồ|trung leng ho
quang kim
pa cheo
nậm pung|nam pung
phìn ngan|phin ngan
cốc san|coc san
tòng sành|tong sanh
pha long
tả ngải chồ|ta ngai cho
tung chung phố|tung chung pho
mường khương|muong khuong
dìn chin|din chin
tả gia khâu|ta gia khau
nậm chảy|nam chay
nấm lư|nam lu
lùng khấu nhin|lung khau nhin
thanh bình|thanh binh
lùng vai|lung vai
bản lầu|ban lau
la pan tẩn|la pan tan
tả thàng|ta thang
bản sen|ban sen
nàn sán|nan san
thào chư phìn|thao chu phin
bản mế|ban me
si ma cai
sán chải|san chai
lùng thẩn|lung than
cán cấu|can cau
sín chéng|sin cheng
quan hồ thẩn|quan ho than
nàn xín|nan xin
bắc hà|bac ha
lùng cải|lung cai
lùng phình|lung phinh
tả van chư|ta van chu
tả củ tỷ|ta cu ty
thải giàng phố|thai giang pho
hoàng thu phố|hoang thu pho
bản phố|ban pho
bản liền|ban lien
tà chải|ta chai
na hối|na hoi
cốc ly|coc ly
nậm mòn|nam mon
nậm đét|nam det
nậm khánh|nam khanh
bảo nhai|bao nhai
nậm lúc|nam luc
cốc lầu|coc lau
bản cái|ban cai
n.t phong hải|n.t phong hai
phố lu|pho lu
tằng loỏng|tang loong
bản phiệt|ban phiet
bản cầm|ban cam
thái niên|thai nien
phong niên|phong nien
gia phú|gia phu
sơn hải|son hai
xuân giao|xuan giao
trì quang|tri quang
sơn hà|son ha
phú nhuận|phu nhuan
phố ràng|pho rang
vĩnh yên|vinh yen
điện quan|dien quan
xuân hoà|xuan hoa
tân dương|tan duong
cam cọn|cam con
xuân thượng|xuan thuong
việt tiến|viet tien
bảo hà|bao ha
lương sơn|luong son
phúc khánh|phuc khanh
sa pa
sa pả|sa pa
ô quý hồ|o quy ho
ngũ chỉ sơn|ngu chi son
phan si păng|phan si pang
trung chải|trung chai
hàm rồng|ham rong
hoàng liên|hoang lien
cầu mây|cau may
mường hoa|muong hoa
tả van|ta van
mường bo|muong bo
bản hồ|ban ho
liên minh|lien minh
khánh yên|khanh yen
võ lao|vo lao
sơn thuỷ|son thuy
nậm mả|nam ma
tân thượng|tan thuong
nậm rạng|nam rang
nậm chầy|nam chay
khánh yên thượng|khanh yen thuong
nậm xé|nam xe
dần thàng|dan thang
chiềng ken|chieng ken
làng giàng|lang giang
hoà mạc|hoa mac
khánh yên trung|khanh yen trung
khánh yên hạ|khanh yen ha
dương quỳ|duong quy
nậm tha|nam tha
minh lương|minh luong
thẩm dương|tham duong
liêm phú|liem phu
nậm xây|nam xay
noong bua
him lam
mường thanh|muong thanh
nam thanh
thanh trường|thanh truong
thanh minh
sông đà|song da
na lay
sín thầu|sin thau
sen thượng|sen thuong
nậm tin|nam tin
chung chải|chung chai
leng su sìn|leng su sin
pá mỳ|pa my
mường nhé|muong nhe
nậm vì|nam vi
nậm kè|nam ke
mường toong|muong toong
pa tần|pa tan
chà cang|cha cang
na cô sa|na co sa
nà khoa|na khoa
nà hỳ|na hy
nà bủng|na bung
nậm nhừ|nam nhu
mường chà|muong cha
nậm chua|nam chua
nậm khăn|nam khan
chà tở|cha to
vàng đán|vang dan
huổi lếnh|huoi lenh
xá tổng|xa tong
mường tùng|muong tung
lay nưa|lay nua
chà nưa|cha nua
hừa ngài|hua ngai
huổi mí|huoi mi
pa ham
nậm nèn|nam nen
huổi lèng|huoi leng
sa lông|sa long
phìn hồ|phin ho
si pa phìn|si pa phin
ma thì hồ|ma thi ho
na sang
mường mươn|muong muon
điện biên đông|dien bien dong
na son
phì nhừ|phi nhu
chiềng sơ|chieng so
mường luân|muong luan
tủa chùa|tua chua
huổi só|huoi so
tả sìn thàng|ta sin thang
lao xả phình|lao xa phinh
tủa thàng|tua thang
trung thu
sính phình|sinh phinh
sáng nhè|sang nhe
mường đun|muong dun
mường báng|muong bang
tuần giáo|tuan giao
mường ảng|muong ang
phình sáng|phinh sang
rạng đông|rang dong
mùn chung|mun chung
nà tòng|na tong
ta ma
mường mùn|muong mun
pú xi|pu xi
pú nhung|pu nhung
quài nưa|quai nua
mường thín|muong thin
tỏa tình|toa tinh
nà sáy|na say
mường khong|muong khong
mường đăng|muong dang
ngối cáy|ngoi cay
quài cang|quai cang
ẳng tở|ang to
quài tở|quai to
chiềng sinh|chieng sinh
chiềng đông|chieng dong
búng lao|bung lao
xuân lao|xuan lao
tênh phông|tenh phong
ẳng nưa|ang nua
ẳng cang|ang cang
nặm lịch|nam lich
mường lạn|muong lan
nà tấu|na tau
nà nhạn|na nhan
mường pồn|muong pon
thanh nưa|thanh nua
hua thanh
mường phăng|muong phang
pá khoang|pa khoang
thanh luông|thanh luong
thanh hưng|thanh hung
thanh xương|thanh xuong
thanh chăn|thanh chan
pa thơm|pa thom
thanh an
thanh yên|thanh yen
noong luống|noong luong
noọng hẹt|noong het
sam mứn|sam mun
pom lót|pom lot
núa ngam|nua ngam
hẹ muông|he muong
na ư|na u
mường nhà|muong nha
na tông|na tong
mường lói|muong loi
phu luông|phu luong
pú nhi|pu nhi
nong u
xa dung
keo lôm|keo lom
luân giới|luan gioi
phình giàng|phinh giang
pú hồng|pu hong
tìa dình|tia dinh
háng lìa|hang lia
tân phong|tan phong
đoàn kết|doan ket
tam đường|tam duong
lả nhì thàng|la nhi thang
thèn sin|then sin
tả lèng|ta leng
sùng phài|sung phai
giang ma
đông phong|dong phong
san thàng|san thang
bình lư|binh lu
sơn bình|son binh
nùng nàng|nung nang
bản giang|ban giang
bản hon|ban hon
bản bo|ban bo
nà tăm|na tam
khun há|khun ha
mường tè|muong te
nậm nhùn|nam nhun
thu lũm|thu lum
ka lăng|ka lang
tá bạ|ta ba
pa ủ|pa u
pa vệ sử|pa ve su
mù cả|mu ca
bum tở|bum to
nậm khao|nam khao
hua bun
tà tổng|ta tong
bum nưa|bum nua
vàng san|vang san
kan hồ|kan ho
mường mô|muong mo
nậm chà|nam cha
nậm manh|nam manh
nậm hàng|nam hang
sìn hồ|sin ho
pú đao|pu dao
chăn nưa|chan nua
nậm pì|nam pi
huổi luông|huoi luong
hồng thu|hong thu
phăng sô lin|phang so lin
ma quai
lùng thàng|lung thang
sà dề phìn|sa de phin
nậm tăm|nam tam
tả ngảo|ta ngao
pu sam cáp|pu sam cap
nậm cha|nam cha
pa khoá|pa khoa
làng mô|lang mo
noong hẻo|noong heo
nậm mạ|nam ma
căn co|can co
tủa sín chải|tua sin chai
nậm cuổi|nam cuoi
nậm hăn|nam han
phong thổ|phong tho
sì lở lầu|si lo lau
mồ sì san|mo si san
pa vây sử|pa vay su
vàng ma chải|vang ma chai
tông qua lìn|tong qua lin
mù sang|mu sang
dào san|dao san
ma ly pho
bản lang|ban lang
hoang thèn|hoang then
khổng lào|khong lao
nậm xe|nam xe
mường so|muong so
sin suối hồ|sin suoi ho
than uyên|than uyen
tân uyên|tan uyen
mường khoa|muong khoa
phúc khoa|phuc khoa
thân thuộc|than thuoc
trung đồng|trung dong
hố mít|ho mit
nậm cần|nam can
nậm sỏ|nam so
pắc ta|pac ta
phúc than|phuc than
mường than|muong than
tà mít|ta mit
mường mít|muong mit
pha mu
mường cang|muong cang
hua nà|hua na
tà hừa|ta hua
mường kim|muong kim
tà mung|ta mung
tà gia|ta gia
khoen on
chiềng lề|chieng le
tô hiệu|to hieu
quyết tâm|quyet tam
chiềng cọ|chieng co
chiềng đen|chieng den
chiềng xôm|chieng xom
chiềng an|chieng an
chiềng cơi|chieng coi
chiềng ngần|chieng ngan
hua la
mường chiên|muong chien
cà nàng|ca nang
chiềng khay|chieng khay
mường giôn|muong gion
pá ma pha khinh|pa ma pha khinh
chiềng ơn|chieng on
mường giàng|muong giang
chiềng bằng|chieng bang
mường sại|muong sai
nậm ét|nam et
chiềng khoang|chieng khoang
thuận châu|thuan chau
phổng lái|phong lai
mường é|muong e
chiềng pha|chieng pha
chiềng la|chieng la
chiềng ngàm|chieng ngam
liệp tè|liep te
é tòng|e tong
phổng lập|phong lap
phổng lăng|phong lang
chiềng ly|chieng ly
noong lay
mường khiêng|muong khieng
mường bám|muong bam
long hẹ|long he
chiềng bôm|chieng bom
thôm mòn|thom mon
tông lạnh|tong lanh
tông cọ|tong co
bó mười|bo muoi
co mạ|co ma
púng tra|pung tra
chiềng pấc|chieng pac
nậm lầu|nam lau
bon phặng|bon phang
co tòng|co tong
muổi nọi|muoi noi
pá lông|pa long
bản lầm|ban lam
ít ong|it ong
nậm giôn|nam gion
chiềng lao|chieng lao
hua trai
ngọc chiến|ngoc chien
mường trai|muong trai
nậm păm|nam pam
chiềng muôn|chieng muon
chiềng ân|chieng an
pi toong
chiềng công|chieng cong
tạ bú|ta bu
chiềng san|chieng san
mường bú|muong bu
chiềng hoa|chieng hoa
mường chùm|muong chum
bắc yên|bac yen
phiêng ban|phieng ban
hang chú|hang chu
xím vàng|xim vang
tà xùa|ta xua
háng đồng|hang dong
pắc ngà|pac nga
làng chếu|lang cheu
chim vàn|chim van
song pe
hồng ngài|hong ngai
tạ khoa|ta khoa
hua nhàn|hua nhan
phiêng côn|phieng con
chiềng sại|chieng sai
phù yên|phu yen
suối tọ|suoi to
mường thải|muong thai
mường cơi|muong coi
quang huy
huy bắc|huy bac
huy thượng|huy thuong
tân lang|tan lang
gia phù|gia phu
tường phù|tuong phu
huy hạ|huy ha
huy tân|huy tan
mường lang|muong lang
suối bau|suoi bau
huy tường|huy tuong
mường do|muong do
sập xa|sap xa
tường thượng|tuong thuong
tường tiến|tuong tien
tường phong|tuong phong
tường hạ|tuong ha
kim bon
mường bang|muong bang
đá đỏ|da do
nam phong
bắc phong|bac phong
mộc châu|moc chau
nt mộc châu|nt moc chau
chiềng sơn|chieng son
tân hợp|tan hop
qui hướng|qui huong
suối bàng|suoi bang
nà mường|na muong
tà lai|ta lai
song khủa|song khua
liên hoà|lien hoa
chiềng hắc|chieng hac
hua păng|hua pang
tô múa|to mua
chiềng khừa|chieng khua
mường sang|muong sang
đông sang|dong sang
chiềng khoa|chieng khoa
mường men|muong men
lóng sập|long sap
vân hồ|van ho
lóng luông|long luong
chiềng yên|chieng yen
chiềng xuân|chieng xuan
xuân nha|xuan nha
tân xuân|tan xuan
yên châu|yen chau
sập vạt|sap vat
chiềng sàng|chieng sang
chiềng pằn|chieng pan
viêng lán|vieng lan
chiềng hặc|chieng hac
mường lựm|muong lum
chiềng on|chieng on
chiềng khoi|chieng khoi
tú nang|tu nang
lóng phiêng|long phieng
phiêng khoài|phieng khoai
chiềng tương|chieng tuong
hát lót|hat lot
chiềng sung|chieng sung
mường bằng|muong bang
chiềng chăn|chieng chan
mương chanh|muong chanh
chiềng ban|chieng ban
chiềng mung|chieng mung
mường bon|muong bon
chiềng chung|chieng chung
chiềng mai|chieng mai
nà pó|na po
cò nòi|co noi
chiềng nơi|chieng noi
phiêng cằm|phieng cam
chiềng dong|chieng dong
chiềng kheo|chieng kheo
chiềng ve|chieng ve
chiềng lương|chieng luong
phiêng pằn|phieng pan
nà ơt|na ot
tà hộc|ta hoc
sông mã|song ma
bó sinh|bo sinh
pú pẩu|pu pau
chiềng phung|chieng phung
chiềng en|chieng en
mường lầm|muong lam
nậm ty|nam ty
đứa mòn|dua mon
yên hưng|yen hung
nà nghịu|na nghiu
nậm mằn|nam man
chiềng khoong|chieng khoong
chiềng cang|chieng cang
huổi một|huoi mot
mường sai|muong sai
mường cai|muong cai
mường hung|muong hung
chiềng khương|chieng khuong
sam kha
púng bánh|pung banh
sốp cộp|sop cop
dồm cang|dom cang
nậm lạnh|nam lanh
mường lèo|muong leo
mường và|muong va
yên ninh|yen ninh
nguyễn thái học|nguyen thai hoc
nguyễn phúc|nguyen phuc
hồng hà|hong ha
minh bảo|minh bao
tuy lộc|tuy loc
pú trạng|pu trang
trung tâm|trung tam
cầu thia|cau thia
nghĩa lợi|nghia loi
nghĩa phúc|nghia phuc
nghĩa an|nghia an
yên thế|yen the
tân phượng|tan phuong
lâm thượng|lam thuong
khánh thiện|khanh thien
minh chuẩn|minh chuan
mai sơn|mai son
khai trung
mường lai|muong lai
tô mậu|to mau
tân lĩnh|tan linh
yên thắng|yen thang
khánh hoà|khanh hoa
vĩnh lạc|vinh lac
liễu đô|lieu do
động quan|dong quan
minh tiến|minh tien
trúc lâu|truc lau
an phú|an phu
mậu a|mau a
lang thíp|lang thip
lâm giang|lam giang
châu quế thượng|chau que thuong
châu quế hạ|chau que ha
an bình|an binh
đông an|dong an
đông cuông|dong cuong
phong dụ hạ|phong du ha
mậu đông|mau dong
ngòi a|ngoi a
xuân tầm|xuan tam
an thịnh|an thinh
yên thái|yen thai
phong dụ thượng|phong du thuong
yên hợp|yen hop
đại phác|dai phac
xuân ái|xuan ai
viễn sơn|vien son
mỏ vàng|mo vang
nà hẩu|na hau
mù căng chải|mu cang chai
hồ bốn|ho bon
nậm có|nam co
khao mang
mồ dề|mo de
chế cu nha|che cu nha
kim nọi|kim noi
cao phạ|cao pha
la pán tẩn|la pan tan
dế su phình|de su phinh
chế tạo|che tao
púng luông|pung luong
nậm khắt|nam khat
cổ phúc|co phuc
tân đồng|tan dong
báo đáp|bao dap
đào thịnh|dao thinh
việt thành|viet thanh
hòa cuông|hoa cuong
minh quán|minh quan
quy mông|quy mong
cường thịnh|cuong thinh
kiên thành|kien thanh
nga quán|nga quan
y can
lương thịnh|luong thinh
âu lâu|au lau
giới phiên|gioi phien
hợp minh|hop minh
bảo hưng|bao hung
việt cường|viet cuong
minh quân|minh quan
hồng ca|hong ca
hưng khánh|hung khanh
vân hội|van hoi
trạm tấu|tram tau
túc đán|tuc dan
pá lau|pa lau
xà hồ|xa ho
phình hồ|phinh ho
tà si láng|ta si lang
pá hu|pa hu
làng nhì|lang nhi
bản công|ban cong
bản mù|ban mu
hát lìu|hat liu
nt liên sơn|nt lien son
nghĩa lộ|nghia lo
nt trần phú|nt tran phu
tú lệ|tu le
nậm búng|nam bung
gia hội|gia hoi
sùng đô|sung do
nậm mười|nam muoi
an lương|an luong
nậm lành|nam lanh
sơn lương|son luong
suối quyền|suoi quyen
suối giàng|suoi giang
sơn a|son a
phù nham|phu nham
nghĩa sơn|nghia son
suối bu|suoi bu
sơn thịnh|son thinh
hạnh sơn|hanh son
thạch lương|thach luong
đại lịch|dai lich
đồng khê|dong khe
cát thịnh|cat thinh
chấn thịnh|chan thinh
bình thuận|binh thuan
thượng bằng la|thuong bang la
minh an
nghĩa tâm|nghia tam
thác bà|thac ba
xuân long|xuan long
cảm nhân|cam nhan
ngọc chấn|ngoc chan
tân nguyên|tan nguyen
bảo ái|bao ai
mỹ gia|my gia
xuân lai|xuan lai
mông sơn|mong son
cảm ân|cam an
tân hương|tan huong
phúc an|phuc an
bạch hà|bach ha
vũ linh|vu linh
đại đồng|dai dong
vĩnh kiên|vinh kien
thịnh hưng|thinh hung
hán đà|han da
đại minh|dai minh
tân hòa|tan hoa
thịnh lang|thinh lang
hữu nghị|huu nghi
phương lâm|phuong lam
yên mông|yen mong
quỳnh lâm|quynh lam
hòa bình|hoa binh
đà bắc|da bac
nánh nghê|nanh nghe
giáp đắt|giap dat
mường chiềng|muong chieng
tân pheo|tan pheo
đồng chum|dong chum
đồng ruộng|dong ruong
tú lý|tu ly
yên hòa|yen hoa
toàn sơn|toan son
hiền lương|hien luong
tiền phong|tien phong
vầy nưa|vay nua
kỳ sơn|ky son
thịnh minh|thinh minh
mông hóa|mong hoa
yên trung|yen trung
tiến xuân|tien xuan
lâm sơn|lam son
hòa sơn|hoa son
tân vinh|tan vinh
nhuận trạch|nhuan trach
cư yên|cu yen
liên sơn|lien son
ba hàng đồi|ba hang doi
đú sáng|du sang
hùng sơn|hung son
bình sơn|binh son
tú sơn|tu son
vĩnh tiến|vinh tien
cao dương|cao duong
đông bắc|dong bac
xuân thủy|xuan thuy
vĩnh đồng|vinh dong
kim lập|kim lap
hợp tiến|hop tien
thanh sơn|thanh son
thanh cao
kim bôi|kim boi
nam thượng|nam thuong
cuối hạ|cuoi ha
sào báy|sao bay
mi hòa|mi hoa
nuông dăm|nuong dam
cao phong
bình thanh|binh thanh
thung nai
thu phong
hợp phong|hop phong
tây phong|tay phong
dũng phong|dung phong
thạch yên|thach yen
mãn đức|man duc
suối hoa|suoi hoa
phú vinh|phu vinh
mỹ hòa|my hoa
quyết chiến|quyet chien
phong phú|phong phu
tử nê|tu ne
thanh hối|thanh hoi
ngọc mỹ|ngoc my
đông lai|dong lai
nhân mỹ|nhan my
lỗ sơn|lo son
ngổ luông|ngo luong
gia mô|gia mo
mai châu|mai chau
sơn thủy|son thuy
pà cò|pa co
hang kia
đồng tân|dong tan
cun pheo
bao la
tòng đậu|tong dau
nà phòn|na phon
săm khóe|sam khoe
chiềng châu|chieng chau
mai hạ|mai ha
thành sơn|thanh son
mai hịch|mai hich
vạn mai|van mai
vụ bản|vu ban
quý hòa|quy hoa
miền đồi|mien doi
mỹ thành|my thanh
tuân đạo|tuan dao
văn nghĩa|van nghia
văn sơn|van son
nhân nghĩa|nhan nghia
thượng cốc|thuong coc
bình hẻm|binh hem
định cư|dinh cu
chí đạo|chi dao
ngọc sơn|ngoc son
hương nhượng|huong nhuong
vũ bình|vu binh
yên nghiệp|yen nghiep
ân nghĩa|an nghia
ngọc lâu|ngoc lau
hàng trạm|hang tram
lạc sỹ|lac sy
lạc lương|lac luong
bảo hiệu|bao hieu
đa phúc|da phuc
hữu lợi|huu loi
lạc thịnh|lac thinh
phú lai|phu lai
yên trị|yen tri
ngọc lương|ngoc luong
chi nê|chi ne
phú nghĩa|phu nghia
phú thành|phu thanh
hưng thi|hung thi
khoan dụ|khoan du
yên bồng|yen bong
quán triều|quan trieu
túc duyên|tuc duyen
trưng vương|trung vuong
phan đình phùng|phan dinh phung
thịnh đán|thinh dan
đồng quang|dong quang
gia sàng|gia sang
cam giá|cam gia
phú xá|phu xa
phúc hà|phuc ha
phúc xuân|phuc xuan
phúc trìu|phuc triu
thịnh đức|thinh duc
tích lương|tich luong
tân cương|tan cuong
châu sơn|chau son
mỏ chè|mo che
cải đan|cai dan
phố cò|pho co
bách quang|bach quang
bá xuyên|ba xuyen
chợ chu|cho chu
linh thông|linh thong
lam vỹ|lam vy
quy kỳ|quy ky
kim phượng|kim phuong
bảo linh|bao linh
phúc chu|phuc chu
phượng tiến|phuong tien
bảo cường|bao cuong
đồng thịnh|dong thinh
định biên|dinh bien
thanh định|thanh dinh
trung hội|trung hoi
trung lương|trung luong
điềm mặc|diem mac
phú tiến|phu tien
bộc nhiêu|boc nhieu
phú đình|phu dinh
bình thành|binh thanh
giang tiên|giang tien
yên trạch|yen trach
yên đổ|yen do
ôn lương|on luong
động đạt|dong dat
phủ lý|phu ly
tức tranh|tuc tranh
phấn mễ|phan me
vô tranh|vo tranh
cổ lũng|co lung
sơn cẩm|son cam
chùa hang|chua hang
trại cau|trai cau
văn lăng|van lang
quang sơn|quang son
minh lập|minh lap
văn hán|van han
hóa trung|hoa trung
khe mo
cây thị|cay thi
hóa thượng|hoa thuong
cao ngạn|cao ngan
linh sơn|linh son
tân lợi|tan loi
nam hòa|nam hoa
đồng bẩm|dong bam
huống thượng|huong thuong
đình cả|dinh ca
sảng mộc|sang moc
nghinh tường|nghinh tuong
thần xa|than xa
vũ chấn|vu chan
thượng nung|thuong nung
cúc đường|cuc duong
la hiên|la hien
lâu thượng|lau thuong
tràng xá|trang xa
phương giao|phuong giao
dân tiến|dan tien
bình long|binh long
quân chu|quan chu
phúc lương|phuc luong
yên lãng|yen lang
đức lương|duc luong
na mao
phú lạc|phu lac
tân linh|tan linh
phục linh|phuc linh
phú xuyên|phu xuyen
bản ngoại|ban ngoai
tiên hội|tien hoi
cù vân|cu van
hà thượng|ha thuong
la bằng|la bang
hoàng nông|hoang nong
khôi kỳ|khoi ky
an khánh|an khanh
tân thái|tan thai
lục ba|luc ba
mỹ yên|my yen
vạn thọ|van tho
văn yên|van yen
ký phú|ky phu
cát nê|cat ne
bãi bông|bai bong
ba hàng|ba hang
phúc thuận|phuc thuan
hồng tiến|hong tien
minh đức|minh duc
đắc sơn|dac son
tiên phong|tien phong
vạn phái|van phai
nam tiến|nam tien
đông cao|dong cao
tân phú|tan phu
thuận thành|thuan thanh
bàn đạt|ban dat
đồng liên|dong lien
tân khánh|tan khanh
tân kim|tan kim
đào xá|dao xa
bảo lý|bao ly
nhã lộng|nha long
điềm thụy|diem thuy
tân đức|tan duc
úc kỳ|uc ky
lương phú|luong phu
nga my
kha sơn|kha son
thanh ninh
dương thành|duong thanh
hà châu|ha chau
tam thanh
vĩnh trại|vinh trai
đông kinh|dong kinh
chi lăng|chi lang
hoàng đồng|hoang dong
quảng lạc|quang lac
mai pha
thất khê|that khe
khánh long|khanh long
quốc khánh|quoc khanh
cao minh
chí minh|chi minh
đào viên|dao vien
kháng chiến|khang chien
quốc việt|quoc viet
hùng việt|hung viet
hồng phong|hong phong
yên lỗ|yen lo
thiện hòa|thien hoa
thiện thuật|thien thuat
thiện long|thien long
bình gia|binh gia
bình la|binh la
tân văn|tan van
na sầm|na sam
bắc la|bac la
bắc hùng|bac hung
tân tác|tan tac
hội hoan|hoi hoan
bắc việt|bac viet
hoàng việt|hoang viet
gia miễn|gia mien
thành hòa|thanh hoa
nhạc kỳ|nhac ky
đồng đăng|dong dang
cao lộc|cao loc
bảo lâm|bao lam
thanh lòa|thanh loa
cao lâu|cao lau
thạch đạn|thach dan
xuất lễ|xuat le
lộc yên|loc yen
hải yến|hai yen
hòa cư|hoa cu
công sơn|cong son
gia cát|gia cat
mẫu sơn|mau son
tân liên|tan lien
văn quan|van quan
trấn ninh|tran ninh
liên hội|lien hoi
tú xuyên|tu xuyen
điềm he|diem he
an sơn|an son
khánh khê|khanh khe
lương năng|luong nang
đồng giáp|dong giap
bình phúc|binh phuc
tràng các|trang cac
tân đoàn|tan doan
tri lễ|tri le
tràng phái|trang phai
yên phúc|yen phuc
hữu lễ|huu le
long đống|long dong
vạn thủy|van thuy
đồng ý|dong y
tân tri|tan tri
bắc quỳnh|bac quynh
hưng vũ|hung vu
vũ sơn|vu son
chiêu vũ|chieu vu
chiến thắng|chien thang
vũ lăng|vu lang
trấn yên|tran yen
vũ lễ|vu le
nhất hòa|nhat hoa
nhất tiến|nhat tien
hữu lũng|huu lung
hữu liên|huu lien
thiện tân|thien tan
yên vượng|yen vuong
nhật tiến|nhat tien
cai kinh
hòa lạc|hoa lac
vân nham|van nham
hồ sơn|ho son
minh hòa|minh hoa
hòa thắng|hoa thang
đồng mỏ|dong mo
vân an|van an
vân thủy|van thuy
gia lộc|gia loc
bắc thủy|bac thuy
mai sao
bằng hữu|bang huu
thượng cường|thuong cuong
bằng mạc|bang mac
vạn linh|van linh
hữu kiên|huu kien
quan sơn|quan son
y tịch|y tich
na dương|na duong
lộc bình|loc binh
yên khoái|yen khoai
tú mịch|tu mich
hữu khánh|huu khanh
đồng bục|dong buc
tam gia
tú đoạn|tu doan
khuất xá|khuat xa
tĩnh bắc|tinh bac
sàn viên|san vien
đông quan|dong quan
minh hiệp|minh hiep
hữu lân|huu lan
lợi bác|loi bac
nam quan
ái quốc|ai quoc
đình lập|dinh lap
nt thái bình|nt thai binh
bắc xa|bac xa
bính xá|binh xa
kiên mộc|kien moc
lâm ca|lam ca
bắc lãng|bac lang
hà khánh|ha khanh
hà phong|ha phong
hà khẩu|ha khau
cao xanh
giếng đáy|gieng day
hà tu|ha tu
hà trung|ha trung
hà lầm|ha lam
bãi cháy|bai chay
cao thắng|cao thang
hùng thắng|hung thang
yết kiêu|yet kieu
hồng hải|hong hai
hồng gai|hong gai
tuần châu|tuan chau
đại yên|dai yen
ka long
ninh dương|ninh duong
hoà lạc|hoa lac
trà cổ|tra co
hải sơn|hai son
hải đông|hai dong
hải tiến|hai tien
hải yên|hai yen
quảng nghĩa|quang nghia
hải hoà|hai hoa
hải xuân|hai xuan
vạn ninh|van ninh
bình ngọc|binh ngoc
vĩnh trung|vinh trung
vĩnh thực|vinh thuc
mông dương|mong duong
cửa ông|cua ong
cẩm sơn|cam son
cẩm đông|cam dong
cẩm phú|cam phu
cẩm tây|cam tay
quang hanh
cẩm thịnh|cam thinh
cẩm thủy|cam thuy
cẩm thạch|cam thach
cẩm thành|cam thanh
cẩm trung|cam trung
cẩm bình|cam binh
cộng hòa|cong hoa
cẩm hải|cam hai
dương huy|duong huy
vàng danh|vang danh
nam khê|nam khe
yên thanh|yen thanh
thượng yên công|thuong yen cong
phương đông|phuong dong
phương nam|phuong nam
bình liêu|binh lieu
hoành mô|hoanh mo
vô ngại|vo ngai
lục hồn|luc hon
húc động|huc dong
hà lâu|ha lau
đại dực|dai duc
phong dụ|phong du
điền xá|dien xa
đông ngũ|dong ngu
yên than|yen than
đông hải|dong hai
hải lạng|hai lang
tiên lãng|tien lang
đồng rui|dong rui
đầm hà|dam ha
tân bình|tan binh
dực yên|duc yen
quảng tân|quang tan
đại bình|dai binh
quảng hà|quang ha
quảng đức|quang duc
quảng sơn|quang son
quảng thành|quang thanh
quảng thịnh|quang thinh
quảng minh|quang minh
quảng chính|quang chinh
quảng long|quang long
đường hoa|duong hoa
quảng phong|quang phong
cái chiên|cai chien
ba chẽ|ba che
thanh lâm|thanh lam
đạp thanh|dap thanh
lương mông|luong mong
đồn đạc|don dac
minh cầm|minh cam
cái rồng|cai rong
đài xuyên|dai xuyen
bình dân|binh dan
vạn yên|van yen
minh châu|minh chau
hạ long|ha long
đông xá|dong xa
quan lạn|quan lan
ngọc vừng|ngoc vung
hoành bồ|hoanh bo
kỳ thượng|ky thuong
đồng sơn|dong son
đồng lâm|dong lam
vũ oai|vu oai
quảng la|quang la
bằng cả|bang ca
mạo khê|mao khe
đông triều|dong trieu
an sinh
tràng lương|trang luong
bình khê|binh khe
việt dân|viet dan
tân việt|tan viet
đức chính|duc chinh
tràng an|trang an
thủy an|thuy an
xuân sơn|xuan son
hồng thái tây|hong thai tay
hồng thái đông|hong thai dong
hoàng quế|hoang que
yên thọ|yen tho
yên đức|yen duc
quảng yên|quang yen
đông mai|dong mai
minh thành|minh thanh
sông khoai|song khoai
hiệp hòa|hiep hoa
tiền an|tien an
hoàng tân|hoang tan
yên giang|yen giang
nam hoà|nam hoa
hà an|ha an
cẩm la|cam la
phong hải|phong hai
yên hải|yen hai
liên hòa|lien hoa
phong cốc|phong coc
liên vị|lien vi
cô tô|co to
thanh lân|thanh lan
thọ xương|tho xuong
trần nguyên hãn|tran nguyen han
ngô quyền|ngo quyen
mỹ độ|my do
song mai
xương giang|xuong giang
đa mai|da mai
dĩnh kế|dinh ke
canh nậu|canh nau
xuân lương|xuan luong
tam tiến|tam tien
đồng vương|dong vuong
đồng hưu|dong huu
tiến thắng|tien thang
đông sơn|dong son
tân hiệp|tan hiep
hương vĩ|huong vi
đồng kỳ|dong ky
an thượng|an thuong
phồn xương|phon xuong
tân sỏi|tan soi
bố hạ|bo ha
lan giới|lan gioi
nhã nam|nha nam
tân trung|tan trung
đại hóa|dai hoa
an dương|an duong
phúc hòa|phuc hoa
hợp đức|hop duc
lam cốt|lam cot
cao xá|cao xa
việt ngọc|viet ngoc
song vân|song van
ngọc châu|ngoc chau
ngọc vân|ngoc van
việt lập|viet lap
liên chung|lien chung
ngọc thiện|ngoc thien
ngọc lý|ngoc ly
quế nham|que nham
nghĩa hòa|nghia hoa
nghĩa hưng|nghia hung
quang thịnh|quang thinh
đào mỹ|dao my
tiên lục|tien luc
an hà|an ha
mỹ hà|my ha
hương lạc|huong lac
dương đức|duong duc
mỹ thái|my thai
xương lâm|xuong lam
xuân hương|xuan huong
tân dĩnh|tan dinh
đại lâm|dai lam
thái đào|thai dao
dĩnh trì|dinh tri
đồi ngô|doi ngo
đông hưng|dong hung
đông phú|dong phu
tam dị|tam di
bảo sơn|bao son
bảo đài|bao dai
tiên nha|tien nha
trường giang|truong giang
phương sơn|phuong son
chu điện|chu dien
cương sơn|cuong son
nghĩa phương|nghia phuong
lan mẫu|lan mau
khám lạng|kham lang
huyền sơn|huyen son
trường sơn|truong son
lục sơn|luc son
bắc lũng|bac lung
vũ xá|vu xa
cẩm lý|cam ly
đan hội|dan hoi
cấm sơn|cam son
phong minh
phong vân|phong van
xa lý|xa ly
hộ đáp|ho dap
thanh hải|thanh hai
kiên lao|kien lao
biên sơn|bien son
hồng giang|hong giang
tân hoa|tan hoa
giáp sơn|giap son
biển động|bien dong
quý sơn|quy son
trù hựu|tru huu
phì điền|phi dien
đồng cốc|dong coc
mỹ an|my an
nam dương|nam duong
tân mộc|tan moc
đèo gia|deo gia
phượng sơn|phuong son
an châu|an chau
tây yên tử|tay yen tu
giáo liêm|giao liem
cẩm đàn|cam dan
vĩnh an|vinh an
lệ viễn|le vien
an bá|an ba
tuấn đạo|tuan dao
dương hưu|duong huu
long sơn|long son
thanh luận|thanh luan
nham biền|nham bien
lão hộ|lao ho
hương gián|huong gian
quỳnh sơn|quynh son
song khê|song khe
nội hoàng|noi hoang
xuân phú|xuan phu
tân liễu|tan lieu
trí yên|tri yen
lãng sơn|lang son
yên lư|yen lu
tiến dũng|tien dung
cảnh thụy|canh thuy
tư mại|tu mai
đồng việt|dong viet
thượng lan|thuong lan
nghĩa trung|nghia trung
hương mai|huong mai
tự lạn|tu lan
bích động|bich dong
tiên sơn|tien son
tăng tiến|tang tien
ninh sơn|ninh son
vân trung|van trung
quang châu|quang chau
hoàng lương|hoang luong
hoàng vân|hoang van
hoàng thanh|hoang thanh
hoàng an|hoang an
lương phong|luong phong
đại thành|dai thanh
thường thắng|thuong thang
hợp thịnh|hop thinh
danh thắng|danh thang
mai trung
đoan bái|doan bai
bắc lý|bac ly
xuân cẩm|xuan cam
hương lâm|huong lam
đông lỗ|dong lo
châu minh|chau minh
dữu lâu|duu lau
vân cơ|van co
nông trang|nong trang
gia cẩm|gia cam
tiên cát|tien cat
thọ sơn|tho son
thanh miếu|thanh mieu
bạch hạc|bach hac
bến gót|ben got
vân phú|van phu
phượng lâu|phuong lau
thụy vân|thuy van
minh phương|minh phuong
minh nông|minh nong
sông lô|song lo
hùng vương|hung vuong
âu cơ|au co
hà lộc|ha loc
phú hộ|phu ho
văn lung|van lung
hà thạch|ha thach
thanh vinh
đoan hùng|doan hung
hùng xuyên|hung xuyen
bằng luân|bang luan
vân du|van du
phú lâm|phu lam
bằng doãn|bang doan
chí đám|chi dam
phúc lai|phuc lai
ngọc quan|ngoc quan
hợp nhất|hop nhat
sóc đăng|soc dang
tây cốc|tay coc
yên kiện|yen kien
hùng long|hung long
vụ quang|vu quang
vân đồn|van don
tiêu sơn|tieu son
chân mộng|chan mong
ca đình|ca dinh
hạ hoà|ha hoa
đại phạm|dai pham
đan thượng|dan thuong
hà lương|ha luong
gia điền|gia dien
ấm hạ|am ha
hương xạ|huong xa
xuân áng|xuan ang
yên kỳ|yen ky
minh hạc|minh hac
lang sơn|lang son
bằng giã|bang gia
yên luật|yen luat
minh côi|minh coi
vĩnh chân|vinh chan
thanh ba
vân lĩnh|van linh
đông lĩnh|dong linh
đại an|dai an
hanh cù|hanh cu
ninh dân|ninh dan
khải xuân|khai xuan
mạn lạn|man lan
hoàng cương|hoang cuong
chí tiên|chi tien
sơn cương|son cuong
thanh hà|thanh ha
đỗ sơn|do son
đỗ xuyên|do xuyen
lương lỗ|luong lo
phú mỹ|phu my
lệ mỹ|le my
liên hoa|lien hoa
trạm thản|tram than
trị quận|tri quan
trung giáp|trung giap
tiên phú|tien phu
hạ giáp|ha giap
bảo thanh|bao thanh
phú lộc|phu loc
gia thanh
tiên du|tien du
phú nham|phu nham
an đạo|an dao
phù ninh|phu ninh
kim đức|kim duc
hùng lô|hung lo
mỹ lung|my lung
mỹ lương|my luong
xuân an|xuan an
xuân viên|xuan vien
hưng long|hung long
nga hoàng|nga hoang
thượng long|thuong long
ngọc lập|ngoc lap
ngọc đồng|ngoc dong
cẩm khê|cam khe
tiên lương|tien luong
ngô xá|ngo xa
phượng vĩ|phuong vi
thụy liễu|thuy lieu
tùng khê|tung khe
văn bán|van ban
cấp dẫn|cap dan
xương thịnh|xuong thinh
phú khê|phu khe
sơn tình|son tinh
yên tập|yen tap
hương lung|huong lung
tạ xá|ta xa
chương xá|chuong xa
văn khúc|van khuc
yên dưỡng|yen duong
điêu lương|dieu luong
đồng lương|dong luong
hưng hoá|hung hoa
hiền quan|hien quan
thanh uyên|thanh uyen
lam sơn|lam son
vạn xuân|van xuan
quang húc|quang huc
hương nộn|huong non
tề lễ|te le
thọ văn|tho van
dị nậu|di nau
dân quyền|dan quyen
lâm thao|lam thao
tiên kiên|tien kien
xuân lũng|xuan lung
hy cương|hy cuong
chu hóa|chu hoa
xuân huy|xuan huy
thạch sơn|thach son
thanh đình|thanh dinh
sơn vi|son vi
phùng nguyên|phung nguyen
vĩnh lại|vinh lai
tứ xã|tu xa
bản nguyên|ban nguyen
thu cúc|thu cuc
thạch kiệt|thach kiet
thu ngạc|thu ngac
kiệt sơn|kiet son
lai đồng|lai dong
sơn hùng|son hung
mỹ thuận|my thuan
địch quả|dich qua
giáp lai|giap lai
thục luyện|thuc luyen
võ miếu|vo mieu
thạch khoán|thach khoan
xuân đài|xuan dai
minh đài|minh dai
văn luông|van luong
cự thắng|cu thang
tất thắng|tat thang
long cốc|long coc
cự đồng|cu dong
kim thượng|kim thuong
thắng sơn|thang son
vinh tiền|vinh tien
hương cần|huong can
khả cửu|kha cuu
đông cửu|dong cuu
yên lương|yen luong
thượng cửu|thuong cuu
lương nha|luong nha
tinh nhuệ|tinh nhue
thạch đồng|thach dong
xuân lộc|xuan loc
tân phương|tan phuong
bảo yên|bao yen
đoan hạ|doan ha
đồng trung|dong trung
hoàng xá|hoang xa
tu vũ|tu vu
tích sơn|tich son
liên bảo|lien bao
hội hợp|hoi hop
đống đa|dong da
định trung|dinh trung
khai quang
thanh trù|thanh tru
trưng trắc|trung trac
trưng nhị|trung nhi
phúc thắng|phuc thang
ngọc thanh|ngoc thanh
nam viêm|nam viem
tiền châu|tien chau
lập thạch|lap thach
hợp lý|hop ly
lãng công|lang cong
quang yên|quang yen
bạch lưu|bach luu
hải lựu|hai luu
bắc bình|bac binh
hoa sơn|hoa son
liễn sơn|lien son
vân trục|van truc
đồng quế|dong que
nhân đạo|nhan dao
đôn nhân|don nhan
phương khoan|phuong khoan
tử du|tu du
nhạo sơn|nhao son
như thụy|nhu thuy
yên thạch|yen thach
bàn giản|ban gian
xuân lôi|xuan loi
đồng ích|dong ich
tiên lữ|tien lu
văn quán|van quan
tứ yên|tu yen
đức bác|duc bac
đình chu|dinh chu
triệu đề|trieu de
sơn đông|son dong
hoàng hoa|hoang hoa
đồng tĩnh|dong tinh
kim long
hướng đạo|huong dao
đạo tú|dao tu
an hòa|an hoa
duy phiên|duy phien
hoàng đan|hoang dan
hoàng lâu|hoang lau
tam đảo|tam dao
hợp châu|hop chau
đạo trù|dao tru
yên dương|yen duong
bồ lý|bo ly
đại đình|dai dinh
tam quan
hương canh|huong canh
gia khánh|gia khanh
trung mỹ|trung my
bá hiến|ba hien
tam hợp|tam hop
quất lưu|quat luu
sơn lôi|son loi
thanh lãng|thanh lang
phú xuân|phu xuan
chi đông|chi dong
đại thịnh|dai thinh
kim hoa
thạch đà|thach da
tự lập|tu lap
tam đồng|tam dong
chu phan
tiến thịnh|tien thinh
mê linh|me linh
văn khê|van khe
hoàng kim|hoang kim
tráng việt|trang viet
đồng cương|dong cuong
bình định|binh dinh
trung nguyên|trung nguyen
tề lỗ|te lo
tam hồng|tam hong
yên đồng|yen dong
văn tiến|van tien
nguyệt đức|nguyet duc
yên phương|yen phuong
hồng phương|hong phuong
trung kiên|trung kien
liên châu|lien chau
đại tự|dai tu
hồng châu|hong chau
vĩnh tường|vinh tuong
kim xá|kim xa
chấn hưng|chan hung
việt xuân|viet xuan
bồ sao|bo sao
lũng hoà|lung hoa
cao đại|cao dai
thổ tang|tho tang
vĩnh sơn|vinh son
thượng trưng|thuong trung
vũ di|vu di
lý nhân|ly nhan
tuân chính|tuan chinh
vân xuân|van xuan
tam phúc|tam phuc
tứ trưng|tu trung
ngũ kiên|ngu kien
vĩnh thịnh|vinh thinh
phú đa|phu da
vĩnh ninh|vinh ninh
vũ ninh|vu ninh
đáp cầu|dap cau
thị cầu|thi cau
kinh bắc|kinh bac
vệ an|ve an
đại phúc|dai phuc
ninh xá|ninh xa
võ cường|vo cuong
dũng liệt|dung liet
tam giang
thụy hòa|thuy hoa
hòa tiến|hoa tien
hòa long|hoa long
đông tiến|dong tien
trung nghĩa|trung nghia
vạn an|van an
long châu|long chau
khúc xuyên|khuc xuyen
văn môn|van mon
phong khê|phong khe
phố mới|pho moi
việt thống|viet thong
đại xuân|dai xuan
kim chân|kim chan
nhân hòa|nhan hoa
bằng an|bang an
phương liễu|phuong lieu
quế tân|que tan
vân dương|van duong
phù lương|phu luong
phù lãng|phu lang
phượng mao|phuong mao
ngọc xá|ngoc xa
châu phong|chau phong
bồng lai|bong lai
cách bi|cach bi
yên giả|yen gia
mộ đạo|mo dao
hán quảng|han quang
khắc niệm|khac niem
nội duệ|noi due
hạp lĩnh|hap linh
liên bão|lien bao
hiên vân|hien van
hoàn sơn|hoan son
lạc vệ|lac ve
việt đoàn|viet doan
phật tích|phat tich
tân chi|tan chi
minh đạo|minh dao
cảnh hưng|canh hung
đông ngàn|dong ngan
hương mạc|huong mac
tương giang|tuong giang
phù khê|phu khe
đồng kỵ|dong ky
trang hạ|trang ha
đồng nguyên|dong nguyen
châu khê|chau khe
tân hồng|tan hong
đình bảng|dinh bang
phù chẩn|phu chan
hoài thượng|hoai thuong
đại đồng thành|dai dong thanh
mão điền|mao dien
song hồ|song ho
đình tổ|dinh to
trí quả|tri qua
gia đông|gia dong
thanh khương|thanh khuong
trạm lộ|tram lo
xuân lâm|xuan lam
hà mãn|ha man
ngũ thái|ngu thai
nghĩa đạo|nghia dao
song liễu|song lieu
gia bình|gia binh
thái bảo|thai bao
giang sơn|giang son
cao đức|cao duc
đại lai|dai lai
song giang
lãng ngâm|lang ngam
nhân thắng|nhan thang
đông cứu|dong cuu
đại bái|dai bai
quỳnh phú|quynh phu
trung kênh|trung kenh
phú hòa|phu hoa
mỹ hương|my huong
tân lãng|tan lang
quảng phú|quang phu
trừng xá|trung xa
lai hạ|lai ha
trung chính|trung chinh
mộ lao|mo lao
la khê|la khe
phú la|phu la
phúc la|phuc la
hà cầu|ha cau
yên nghĩa|yen nghia
kiến hưng|kien hung
phú lãm|phu lam
sơn lộc|son loc
xuân khanh|xuan khanh
đường lâm|duong lam
viên sơn|vien son
trung hưng|trung hung
thanh mỹ|thanh my
trung sơn trầm|trung son tram
cổ đông|co dong
tây đằng|tay dang
cổ đô|co do
tản hồng|tan hong
vạn thắng|van thang
phú đông|phu dong
phú phương|phu phuong
phú châu|phu chau
đồng thái|dong thai
phú sơn|phu son
vật lại|vat lai
chu minh
tòng bạt|tong bat
cẩm lĩnh|cam linh
sơn đà|son da
đông quang|dong quang
thụy an|thuy an
cam thượng|cam thuong
thuần mỹ|thuan my
tản lĩnh|tan linh
ba trại|ba trai
ba vì|ba vi
vân hòa|van hoa
yên bài|yen bai
khánh thượng|khanh thuong
phúc thọ|phuc tho
vân phúc|van phuc
vân nam|van nam
xuân đình|xuan dinh
sen phương|sen phuong
võng xuyên|vong xuyen
thọ lộc|tho loc
long xuyên|long xuyen
hát môn|hat mon
tích giang|tich giang
thanh đa|thanh da
trạch mỹ lộc|trach my loc
ngọc tảo|ngoc tao
phụng thượng|phung thuong
tam thuấn|tam thuan
hiệp thuận|hiep thuan
trung châu|trung chau
thọ an|tho an
thọ xuân|tho xuan
liên hồng|lien hong
hạ mỗ|ha mo
liên trung|lien trung
phương đình|phuong dinh
thượng mỗ|thuong mo
tân hội|tan hoi
đan phượng|dan phuong
đồng tháp|dong thap
song phượng|song phuong
trạm trôi|tram troi
đức thượng|duc thuong
dương liễu|duong lieu
di trạch|di trach
cát quế|cat que
sơn đồng|son dong
vân canh|van canh
đắc sở|dac so
lại yên|lai yen
tiền yên|tien yen
song phương|song phuong
vân côn|van con
dương nội|duong noi
la phù|la phu
đông la|dong la
quốc oai|quoc oai
sài sơn|sai son
phượng cách|phuong cach
ngọc liệp|ngoc liep
liệp tuyết|liep tuyet
thạch thán|thach than
phú cát|phu cat
tuyết nghĩa|tuyet nghia
nghĩa hương|nghia huong
phú mãn|phu man
cấn hữu|can huu
hòa thạch|hoa thach
đông yên|dong yen
liên quan|lien quan
cẩm yên|cam yen
lại thượng|lai thuong
phú kim|phu kim
hương ngải|huong ngai
chàng sơn|chang son
thạch hoà|thach hoa
cần kiệm|can kiem
hữu bằng|huu bang
phùng xá|phung xa
tân xã|tan xa
thạch xá|thach xa
hạ bằng|ha bang
đồng trúc|dong truc
chúc sơn|chuc son
xuân mai|xuan mai
phụng châu|phung chau
tiên phương|tien phuong
đông phương yên|dong phuong yen
trường yên|truong yen
ngọc hòa|ngoc hoa
thủy xuân tiên|thuy xuan tien
thụy hương|thuy huong
tốt động|tot dong
lam điền|lam dien
nam phương tiến|nam phuong tien
hợp đồng|hop dong
hoàng diệu|hoang dieu
hữu văn|huu van
quảng bị|quang bi
thượng vực|thuong vuc
đồng phú|dong phu
văn võ|van vo
hòa chính|hoa chinh
phú nam an|phu nam an
kim bài|kim bai
đồng mai|dong mai
cự khê|cu khe
biên giang|bien giang
bích hòa|bich hoa
cao viên|cao vien
tam hưng|tam hung
thanh thùy|thanh thuy
thanh văn|thanh van
đỗ động|do dong
kim an
kim thư|kim thu
phương trung|phuong trung
tân ước|tan uoc
dân hòa|dan hoa
hồng dương|hong duong
thường tín|thuong tin
ninh sở|ninh so
nhị khê|nhi khe
duyên thái|duyen thai
khánh hà|khanh ha
văn bình|van binh
hiền giang|hien giang
hồng vân|hong van
vân tảo|van tao
liên phương|lien phuong
tự nhiên|tu nhien
hà hồi|ha hoi
thư phú|thu phu
quất động|quat dong
dũng tiến|dung tien
nghiêm xuyên|nghiem xuyen
văn tự|van tu
vạn điểm|van diem
minh cường|minh cuong
hồng minh|hong minh
phượng dực|phuong duc
tri trung
đại thắng|dai thang
phú túc|phu tuc
văn hoàng|van hoang
hoàng long|hoang long
nam triều|nam trieu
chuyên mỹ|chuyen my
khai thái|khai thai
phúc tiến|phuc tien
vân từ|van tu
tri thủy|tri thuy
đại xuyên|dai xuyen
phú yên|phu yen
bạch hạ|bach ha
quang lãng|quang lang
châu can|chau can
vân đình|van dinh
viên an|vien an
viên nội|vien noi
quảng phú cầu|quang phu cau
trường thịnh|truong thinh
cao thành|cao thanh
liên bạt|lien bat
sơn công|son cong
phương tú|phuong tu
trung tú|trung tu
tảo dương văn|tao duong van
vạn thái|van thai
hòa lâm|hoa lam
hòa xá|hoa xa
trầm lộng|tram long
kim đường|kim duong
hòa nam|hoa nam
đại hùng|dai hung
đại cường|dai cuong
lưu hoàng|luu hoang
đại nghĩa|dai nghia
tuy lai
phúc lâm|phuc lam
bột xuyên|bot xuyen
an mỹ|an my
hồng sơn|hong son
lê thanh|le thanh
xuy xá|xuy xa
phù lưu tế|phu luu te
đại hưng|dai hung
vạn kim|van kim
đốc tín|doc tin
hùng tiến|hung tien
an tiến|an tien
hợp thanh|hop thanh
cẩm thượng|cam thuong
bình hàn|binh han
nhị châu|nhi chau
phạm ngũ lão|pham ngu lao
lê thanh nghị|le thanh nghi
hải tân|hai tan
tứ minh|tu minh
việt hoà|viet hoa
phả lại|pha lai
sao đỏ|sao do
bến tắm|ben tam
hoàng hoa thám|hoang hoa tham
bắc an|bac an
hoàng tiến|hoang tien
cộng hoà|cong hoa
cổ thành|co thanh
văn an|van an
nhân huệ|nhan hue
nam sách|nam sach
nam hưng|nam hung
nam tân|nam tan
hiệp cát|hiep cat
thanh quang
quốc tuấn|quoc tuan
nam chính|nam chinh
nam trung
thái tân|thai tan
an lâm|an lam
phú điền|phu dien
an lưu|an luu
thất hùng|that hung
lê ninh|le ninh
hoành sơn|hoanh son
phạm thái|pham thai
duy tân|duy tan
phú thứ|phu thu
thăng long|thang long
lạc long|lac long
hiệp sơn|hiep son
thượng quận|thuong quan
an phụ|an phu
hiệp an|hiep an
thái thịnh|thai thinh
hiến thành|hien thanh
phú thái|phu thai
lai vu
thượng vũ|thuong vu
cổ dũng|co dung
tuấn việt|tuan viet
kim xuyên|kim xuyen
phúc thành a|phuc thanh a
ngũ phúc|ngu phuc
kim anh
kim đính|kim dinh
tam kỳ|tam ky
đồng cẩm|dong cam
đại đức|dai duc
cẩm chế|cam che
thanh lang
tiền tiến|tien tien
thanh khê|thanh khe
thanh xá|thanh xa
an phượng|an phuong
thanh hồng|thanh hong
thanh cường|thanh cuong
vĩnh lập|vinh lap
cẩm giang|cam giang
lai cách|lai cach
cẩm hưng|cam hung
cẩm hoàng|cam hoang
cẩm văn|cam van
ngọc liên|ngoc lien
thạch lỗi|thach loi
cẩm vũ|cam vu
định sơn|dinh son
lương điền|luong dien
cao an
tân trường|tan truong
cẩm phúc|cam phuc
cẩm điền|cam dien
cẩm đoài|cam doai
kẻ sặt|ke sat
vĩnh hồng|vinh hong
thúc kháng|thuc khang
hồng khê|hong khe
cổ bì|co bi
nhân quyền|nhan quyen
thái dương|thai duong
bình xuyên|binh xuyen
thạch khôi|thach khoi
gia xuyên|gia xuyen
gia tân|gia tan
gia lương|gia luong
toàn thắng|toan thang
hồng hưng|hong hung
phạm trấn|pham tran
đoàn thượng|doan thuong
thống kênh|thong kenh
đức xương|duc xuong
tứ kỳ|tu ky
ngọc kỳ|ngoc ky
bình lăng|binh lang
tái sơn|tai son
quang phục|quang phuc
tân kỳ|tan ky
quang khải|quang khai
đại hợp|dai hop
quảng nghiệp|quang nghiep
an thanh
văn tố|van to
phượng kỳ|phuong ky
cộng lạc|cong lac
tiên động|tien dong
nguyên giáp|nguyen giap
hà kỳ|ha ky
hà thanh|ha thanh
ninh giang
ứng hoè|ung hoe
hồng đức|hong duc
an đức|an duc
vĩnh hòa|vinh hoa
đông xuyên|dong xuyen
ninh hải|ninh hai
kiến quốc|kien quoc
hồng dụ|hong du
văn hội|van hoi
hồng phúc|hong phuc
thanh miện|thanh mien
thanh tùng|thanh tung
phạm kha|pham kha
đoàn tùng|doan tung
lê hồng|le hong
tứ cường|tu cuong
ngũ hùng|ngu hung
chi lăng bắc|chi lang bac
chi lăng nam|chi lang nam
thanh giang
quán toan|quan toan
sở dầu|so dau
thượng lý|thuong ly
hạ lý|ha ly
trại chuối|trai chuoi
phan bội châu|phan boi chau
máy chai|may chai
máy tơ|may to
vạn mỹ|van my
cầu tre|cau tre
lạc viên|lac vien
cầu đất|cau dat
gia viên|gia vien
đằng giang|dang giang
lạch tray|lach tray
đổng quốc bình|dong quoc binh
cát dài|cat dai
an biên|an bien
hồ nam|ho nam
dư hàng|du hang
hàng kênh|hang kenh
niệm nghĩa|niem nghia
nghĩa xá|nghia xa
dư hàng kênh|du hang kenh
kênh dương|kenh duong
vĩnh niệm|vinh niem
đông hải 1|dong hai 1
đông hải 2|dong hai 2
đằng lâm|dang lam
thành tô|thanh to
đằng hải|dang hai
nam hải|nam hai
cát bi|cat bi
tràng cát|trang cat
quán trữ|quan tru
lãm hà|lam ha
đồng hoà|dong hoa
trần thành ngọ|tran thanh ngo
văn đẩu|van dau
phù liễn|phu lien
tràng minh|trang minh
ngọc xuyên|ngoc xuyen
vạn hương|van huong
bàng la|bang la
núi đèo|nui deo
lại xuân|lai xuan
liên khê|lien khe
lưu kiếm|luu kiem
lưu kỳ|luu ky
gia minh
gia đức|gia duc
quảng thanh|quang thanh
chính mỹ|chinh my
kênh giang|kenh giang
cao nhân|cao nhan
mỹ đồng|my dong
hoà bình|hoa binh
an lư|an lu
thuỷ triều|thuy trieu
phục lễ|phuc le
phả lễ|pha le
lập lễ|lap le
kiền bái|kien bai
thiên hương|thien huong
thuỷ sơn|thuy son
thuỷ đường|thuy duong
hoàng động|hoang dong
lâm động|lam dong
hoa động|hoa dong
dương quan|duong quan
lê thiện|le thien
đại bản|dai ban
an hoà|an hoa
an hưng|an hung
an hồng|an hong
đặng cương|dang cuong
an đồng|an dong
an lão|an lao
bát trang|bat trang
trường thọ|truong tho
trường thành|truong thanh
quang hưng|quang hung
tân viên|tan vien
mỹ đức|my duc
an thọ|an tho
an thái|an thai
núi đối|nui doi
anh dũng|anh dung
hải thành|hai thanh
đông phương|dong phuong
thuận thiên|thuan thien
hoà nghĩa|hoa nghia
du lễ|du le
thuỵ hương|thuy huong
đại hà|dai ha
ngũ đoan|ngu doan
đoàn xá|doan xa
tiên cường|tien cuong
tự cường|tu cuong
khởi nghĩa|khoi nghia
tiên thanh|tien thanh
đoàn lập|doan lap
tiên thắng|tien thang
tiên minh|tien minh
bắc hưng|bac hung
tây hưng|tay hung
vĩnh bảo|vinh bao
thắng thuỷ|thang thuy
trung lập|trung lap
vĩnh long|vinh long
hiệp hoà|hiep hoa
nhân hoà|nhan hoa
hưng nhân|hung nhan
đồng minh|dong minh
liên am|lien am
lý học|ly hoc
tam cường|tam cuong
cộng hiền|cong hien
cổ am|co am
trấn dương|tran duong
cát bà|cat ba
cát hải|cat hai
đồng bài|dong bai
hoàng châu|hoang chau
văn phong|van phong
phù long|phu long
gia luận|gia luan
hiền hào|hien hao
trân châu|tran chau
việt hải|viet hai
xuân đám|xuan dam
hiến nam|hien nam
an tảo|an tao
quảng châu|quang chau
bảo khê|bao khe
như quỳnh|nhu quynh
lạc đạo|lac dao
chỉ đạo|chi dao
đình dù|dinh du
minh hải|minh hai
lương tài|luong tai
lạc hồng|lac hong
văn giang|van giang
xuân quan|xuan quan
cửu cao|cuu cao
phụng công|phung cong
nghĩa trụ|nghia tru
long hưng|long hung
vĩnh khúc|vinh khuc
liên nghĩa|lien nghia
mễ sở|me so
giai phạm|giai pham
nghĩa hiệp|nghia hiep
đồng than|dong than
liêu xá|lieu xa
hoàn long|hoan long
lý thường kiệt|ly thuong kiet
bần yên nhân|ban yen nhan
cẩm xá|cam xa
hòa phong|hoa phong
dị sử|di su
bạch sam|bach sam
xuân dục|xuan duc
ân thi|an thi
phù ủng|phu ung
bãi sậy|bai say
đào dương|dao duong
tân phúc|tan phuc
xuân trúc|xuan truc
quảng lãng|quang lang
văn nhuệ|van nhue
đặng lễ|dang le
cẩm ninh|cam ninh
đa lộc|da loc
hồ tùng mậu|ho tung mau
hạ lễ|ha le
khoái châu|khoai chau
đông tảo|dong tao
dạ trạch|da trach
hàm tử|ham tu
ông đình|ong dinh
tứ dân|tu dan
an vĩ|an vi
đông kết|dong ket
bình kiều|binh kieu
tân châu|tan chau
phùng hưng|phung hung
việt hòa|viet hoa
đông ninh|dong ninh
đại tập|dai tap
chí tân|chi tan
thuần hưng|thuan hung
nhuế dương|nhue duong
nghĩa dân|nghia dan
vĩnh xá|vinh xa
thọ vinh|tho vinh
đồng thanh|dong thanh
chính nghĩa|chinh nghia
nhân la|nhan la
đức hợp|duc hop
hiệp cường|hiep cuong
hùng cường|hung cuong
dị chế|di che
lệ xá|le xa
an viên|an vien
trung dũng|trung dung
hải triều|hai trieu
thủ sỹ|thu sy
thiện phiến|thien phien
thụy lôi|thuy loi
cương chính|cuong chinh
minh phượng|minh phuong
phương chiểu|phuong chieu
hoàng hanh|hoang hanh
trần cao|tran cao
phan sào nam|phan sao nam
minh hoàng|minh hoang
đoàn đào|doan dao
tống phan|tong phan
đình cao|dinh cao
nhật quang|nhat quang
nguyên hòa|nguyen hoa
tống trân|tong tran
lê hồng phong|le hong phong
bồ xuyên|bo xuyen
kỳ bá|ky ba
phú khánh|phu khanh
trần lãm|tran lam
đông hòa|dong hoa
vũ phúc|vu phuc
vũ chính|vu chinh
quỳnh côi|quynh coi
an khê|an khe
quỳnh hoa|quynh hoa
quỳnh thọ|quynh tho
an hiệp|an hiep
quỳnh hoàng|quynh hoang
quỳnh giao|quynh giao
an cầu|an cau
quỳnh hồng|quynh hong
quỳnh khê|quynh khe
quỳnh minh|quynh minh
an ninh
quỳnh ngọc|quynh ngoc
quỳnh hải|quynh hai
an bài|an bai
an ấp|an ap
quỳnh hội|quynh hoi
quỳnh mỹ|quynh my
an quí|an qui
an vũ|an vu
an lễ|an le
quỳnh hưng|quynh hung
quỳnh bảo|quynh bao
quỳnh nguyên|quynh nguyen
an vinh
quỳnh xá|quynh xa
an dục|an duc
quỳnh trang|quynh trang
an tràng|an trang
hưng hà|hung ha
điệp nông|diep nong
tân lễ|tan le
hùng dũng|hung dung
văn cẩm|van cam
đông đô|dong do
tây đô|tay do
tiến đức|tien duc
thái hưng|thai hung
thái phương|thai phuong
hồng lĩnh|hong linh
chí hòa|chi hoa
đô lương|do luong
liên giang|lien giang
đông cường|dong cuong
lô giang|lo giang
nguyên xá|nguyen xa
hà giang|ha giang
đông hợp|dong hop
đông các|dong cac
đông tân|dong tan
đông vinh|dong vinh
đông động|dong dong
hồng bạch|hong bach
trọng quan|trong quan
đông á|dong a
đông hoàng|dong hoang
đông dương|dong duong
diêm điền|diem dien
thụy trường|thuy truong
hồng dũng|hong dung
thụy quỳnh|thuy quynh
an tân|an tan
thụy ninh|thuy ninh
thụy hưng|thuy hung
thụy việt|thuy viet
thụy văn|thuy van
thụy xuân|thuy xuan
dương phúc|duong phuc
thụy trình|thuy trinh
thụy bình|thuy binh
thụy chính|thuy chinh
thụy dân|thuy dan
thụy hải|thuy hai
thụy liên|thuy lien
thụy duyên|thuy duyen
thụy thanh|thuy thanh
thụy sơn|thuy son
thụy phong|thuy phong
thái thượng|thai thuong
thái nguyên|thai nguyen
dương hồng thủy|duong hong thuy
thái giang|thai giang
thái phúc|thai phuc
thái đô|thai do
thái xuyên|thai xuyen
mỹ lộc|my loc
tân học|tan hoc
thuần thành|thuan thanh
thái thọ|thai tho
tiền hải|tien hai
đông trà|dong tra
đông long|dong long
đông quí|dong qui
tây lương|tay luong
tây ninh|tay ninh
đông trung|dong trung
đông cơ|dong co
tây giang|tay giang
đông lâm|dong lam
phương công|phuong cong
tây tiến|tay tien
vân trường|van truong
nam thắng|nam thang
bắc hải|bac hai
nam thịnh|nam thinh
nam hà|nam ha
nam phú|nam phu
kiến xương|kien xuong
trà giang|tra giang
vũ đông|vu dong
tây sơn|tay son
bình nguyên|binh nguyen
vũ lạc|vu lac
thanh tân|thanh tan
thượng hiền|thuong hien
vũ an|vu an
quang lịch|quang lich
vũ quí|vu qui
quang bình|quang binh
vũ trung|vu trung
vũ thắng|vu thang
vũ công|vu cong
vũ hòa|vu hoa
nam bình|nam binh
vũ thư|vu thu
hồng lý|hong ly
phúc thành|phuc thanh
song lãng|song lang
minh lãng|minh lang
dũng nghĩa|dung nghia
tam quang
bách thuận|bach thuan
tự tân|tu tan
song an
trung an
vũ hội|vu hoi
việt thuận|viet thuan
vũ vinh|vu vinh
vũ đoài|vu doai
vũ tiến|vu tien
vũ vân|vu van
duy nhất|duy nhat
lương khánh thiện|luong khanh thien
hai bà trưng|hai ba trung
lam hạ|lam ha
phù vân|phu van
liêm chính|liem chinh
liêm chung|liem chung
thanh châu|thanh chau
hòa mạc|hoa mac
mộc bắc|moc bac
châu giang|chau giang
bạch thượng|bach thuong
duy minh
mộc nam|moc nam
duy hải|duy hai
chuyên ngoại|chuyen ngoai
yên bắc|yen bac
trác văn|trac van
tiên nội|tien noi
hoàng đông|hoang dong
yên nam|yen nam
tiên ngoại|tien ngoai
tiên tân|tien tan
tiên hiệp|tien hiep
tiên hải|tien hai
nguyễn úy|nguyen uy
đại cương|dai cuong
lê hồ|le ho
tượng lĩnh|tuong linh
nhật tựu|nhat tuu
đồng hóa|dong hoa
hoàng tây|hoang tay
văn xá|van xa
khả phong|kha phong
ba sao
thi sơn|thi son
kiện khê|kien khe
liêm tuyền|liem tuyen
liêm tiết|liem tiet
liêm phong|liem phong
liêm cần|liem can
thanh tuyền|thanh tuyen
liêm thuận|liem thuan
thanh phong
liêm túc|liem tuc
liêm sơn|liem son
thanh hương|thanh huong
thanh nghị|thanh nghi
thanh tâm|thanh tam
thanh nguyên|thanh nguyen
bình mỹ|binh my
bình nghĩa|binh nghia
đinh xá|dinh xa
trịnh xá|trinh xa
đồng du|dong du
ngọc lũ|ngoc lu
hưng công|hung cong
đồn xá|don xa
bối cầu|boi cau
an nội|an noi
vũ bản|vu ban
an đổ|an do
la sơn|la son
tiêu động|tieu dong
nguyên lý|nguyen ly
chính lý|chinh ly
chân lý|chan ly
đạo lý|dao ly
công lý|cong ly
văn lý|van ly
đức lý|duc ly
vĩnh trụ|vinh tru
nhân thịnh|nhan thinh
nhân khang|nhan khang
nhân bình|nhan binh
phú phúc|phu phuc
xuân khê|xuan khe
hòa hậu|hoa hau
trần tế xương|tran te xuong
vị hoàng|vi hoang
cửa bắc|cua bac
bà triệu|ba trieu
trường thi|truong thi
trần đăng ninh|tran dang ninh
năng tĩnh|nang tinh
trần quang khải|tran quang khai
lộc hạ|loc ha
lộc vượng|loc vuong
lộc hòa|loc hoa
mỹ xá|my xa
lộc an|loc an
nam vân|nam van
mỹ tiến|my tien
mỹ thắng|my thang
mỹ trung|my trung
mỹ tân|my tan
mỹ phúc|my phuc
mỹ thịnh|my thinh
minh thuận|minh thuan
hiển khánh|hien khanh
hợp hưng|hop hung
thành lợi|thanh loi
kim thái|kim thai
vĩnh hào|vinh hao
yên tân|yen tan
yên lợi|yen loi
yên chính|yen chinh
yên khánh|yen khanh
yên hồng|yen hong
yên quang|yen quang
yên tiến|yen tien
yên lộc|yen loc
yên bằng|yen bang
yên khang|yen khang
yên nhân|yen nhan
liễu đề|lieu de
nghĩa đồng|nghia dong
nghĩa thịnh|nghia thinh
nghĩa minh|nghia minh
nghĩa thái|nghia thai
hoàng nam|hoang nam
nghĩa châu|nghia chau
nghĩa lạc|nghia lac
nghĩa hồng|nghia hong
nghĩa phong|nghia phong
nghĩa phú|nghia phu
nghĩa bình|nghia binh
quỹ nhất|quy nhat
nghĩa hùng|nghia hung
nghĩa lâm|nghia lam
nghĩa thành|nghia thanh
nghĩa hải|nghia hai
nam điền|nam dien
nam giang
nam mỹ|nam my
nam toàn|nam toan
nam hùng|nam hung
nam hoa
nam lợi|nam loi
nam thái|nam thai
cổ lễ|co le
phương định|phuong dinh
trực chính|truc chinh
trung đông|trung dong
liêm hải|liem hai
trực tuấn|truc tuan
trực đạo|truc dao
trực hưng|truc hung
trực nội|truc noi
cát thành|cat thanh
trực thanh|truc thanh
trực khang|truc khang
trực thuận|truc thuan
trực mỹ|truc my
trực đại|truc dai
trực cường|truc cuong
ninh cường|ninh cuong
trực thái|truc thai
trực hùng|truc hung
trực thắng|truc thang
xuân châu|xuan chau
xuân hồng|xuan hong
xuân thành|xuan thanh
xuân phong|xuan phong
xuân tân|xuan tan
xuân ngọc|xuan ngoc
xuân bắc|xuan bac
thọ nghiệp|tho nghiep
xuân trung|xuan trung
xuân vinh|xuan vinh
xuân kiên|xuan kien
xuân tiến|xuan tien
xuân ninh|xuan ninh
ngô đồng|ngo dong
quất lâm|quat lam
giao hương|giao huong
hồng thuận|hong thuan
giao thiện|giao thien
giao thanh
bình hòa|binh hoa
giao tiến|giao tien
giao hà|giao ha
giao nhân|giao nhan
giao an
giao lạc|giao lac
giao châu|giao chau
giao tân|giao tan
giao yến|giao yen
giao xuân|giao xuan
giao thịnh|giao thinh
giao hải|giao hai
bạch long|bach long
giao long
giao phong
thịnh long|thinh long
hải nam|hai nam
hải trung|hai trung
hải vân|hai van
hải minh|hai minh
hải anh|hai anh
hải hưng|hai hung
hải bắc|hai bac
hải phúc|hai phuc
hải thanh|hai thanh
hải hà|hai ha
hải long|hai long
hải phương|hai phuong
hải đường|hai duong
hải lộc|hai loc
hải quang|hai quang
hải phong|hai phong
hải an|hai an
hải tây|hai tay
hải lý|hai ly
hải phú|hai phu
hải giang|hai giang
hải cường|hai cuong
hải ninh|hai ninh
hải chính|hai chinh
hải châu|hai chau
hải hòa|hai hoa
vân giang|van giang
bích đào|bich dao
nam thành|nam thanh
ninh khánh|ninh khanh
ninh nhất|ninh nhat
ninh tiến|ninh tien
ninh phúc|ninh phuc
ninh phong
nho quan
xích thổ|xich tho
gia lâm|gia lam
gia sơn|gia son
thạch bình|thach binh
gia thủy|gia thuy
gia tường|gia tuong
cúc phương|cuc phuong
lạc vân|lac van
đồng phong|dong phong
lạng phong|lang phong
thượng hòa|thuong hoa
văn phương|van phuong
thanh lạc|thanh lac
sơn lai|son lai
kỳ phú|ky phu
quỳnh lưu|quynh luu
phú long|phu long
gia hòa|gia hoa
gia hưng|gia hung
gia vân|gia van
gia xuân|gia xuan
gia lập|gia lap
gia vượng|gia vuong
gia trấn|gia tran
gia thịnh|gia thinh
gia phương|gia phuong
gia thắng|gia thang
gia trung
gia lạc|gia lac
gia tiến|gia tien
gia sinh
gia phong
thiên tôn|thien ton
ninh khang
ninh mỹ|ninh my
ninh hòa|ninh hoa
ninh xuân|ninh xuan
ninh thắng|ninh thang
ninh vân|ninh van
ninh an
khánh tiên|khanh tien
khánh phú|khanh phu
khánh hòa|khanh hoa
khánh lợi|khanh loi
khánh an|khanh an
khánh cường|khanh cuong
khánh cư|khanh cu
khánh hải|khanh hai
khánh trung|khanh trung
khánh mậu|khanh mau
khánh vân|khanh van
khánh hội|khanh hoi
khánh công|khanh cong
khánh thành|khanh thanh
khánh nhạc|khanh nhac
khánh thủy|khanh thuy
khánh hồng|khanh hong
phát diệm|phat diem
hồi ninh|hoi ninh
xuân chính|xuan chinh
kim định|kim dinh
ân hòa|an hoa
quang thiện|quang thien
như hòa|nhu hoa
chất bình|chat binh
đồng hướng|dong huong
kim chính|kim chinh
thượng kiệm|thuong kiem
lưu phương|luu phuong
lai thành|lai thanh
định hóa|dinh hoa
văn hải|van hai
kim mỹ|kim my
cồn thoi|con thoi
kim hải|kim hai
kim trung
kim đông|kim dong
khánh dương|khanh duong
khánh thịnh|khanh thinh
yên từ|yen tu
yên mạc|yen mac
nam ngạn|nam ngan
ba đình|ba dinh
ngọc trạo|ngoc trao
đông vệ|dong ve
đông cương|dong cuong
đông hương|dong huong
quảng thắng|quang thang
quảng cư|quang cu
quảng tiến|quang tien
mường lát|muong lat
tam chung
mường lý|muong ly
trung lý|trung ly
quang chiểu|quang chieu
pù nhi|pu nhi
nhi sơn|nhi son
mường chanh|muong chanh
hồi xuân|hoi xuan
phú thanh|phu thanh
phú lệ|phu le
hiền chung|hien chung
hiền kiệt|hien kiet
thiên phủ|thien phu
phú nghiêm|phu nghiem
nam xuân|nam xuan
nam động|nam dong
cành nàng|canh nang
điền thượng|dien thuong
điền hạ|dien ha
điền quang|dien quang
điền trung|dien trung
lương ngoại|luong ngoai
ái thượng|ai thuong
lương nội|luong noi
điền lư|dien lu
lương trung|luong trung
lũng niêm|lung niem
lũng cao|lung cao
hạ trung|ha trung
thành lâm|thanh lam
ban công|ban cong
kỳ tân|ky tan
văn nho|van nho
thiết ống|thiet ong
thiết kế|thiet ke
trung xuân|trung xuan
trung thượng|trung thuong
trung tiến|trung tien
trung hạ|trung ha
na mèo|na meo
sơn lư|son lu
tam lư|tam lu
sơn điện|son dien
mường mìn|muong min
yên khương|yen khuong
trí nang|tri nang
tam văn|tam van
lâm phú|lam phu
lang chánh|lang chanh
ngọc lặc|ngoc lac
thúy sơn|thuy son
thạch lập|thach lap
vân âm|van am
cao ngọc|cao ngoc
lộc thịnh|loc thinh
cao thịnh|cao thinh
ngọc trung|ngoc trung
phùng giáo|phung giao
phùng minh|phung minh
nguyệt ấn|nguyet an
kiên thọ|kien tho
phong sơn|phong son
cẩm quý|cam quy
cẩm lương|cam luong
cẩm liên|cam lien
cẩm tú|cam tu
cẩm châu|cam chau
cẩm tâm|cam tam
cẩm ngọc|cam ngoc
cẩm long|cam long
cẩm tân|cam tan
cẩm vân|cam van
thạch quảng|thach quang
thạch tượng|thach tuong
thạch cẩm|thach cam
thạch định|thach dinh
thạch long|thach long
thành mỹ|thanh my
thành yên|thanh yen
thành vinh|thanh vinh
thành minh|thanh minh
thành tân|thanh tan
thành trực|thanh truc
thành tâm|thanh tam
thành an|thanh an
thành thọ|thanh tho
thành tiến|thanh tien
thành hưng|thanh hung
hà long|ha long
hà vinh|ha vinh
hà bắc|ha bac
hoạt giang|hoat giang
lĩnh toại|linh toai
hà ngọc|ha ngoc
yến sơn|yen son
hà sơn|ha son
hà lĩnh|ha linh
hà đông|ha dong
hà tân|ha tan
hà tiến|ha tien
hà bình|ha binh
hà lai|ha lai
hà thái|ha thai
hà hải|ha hai
vĩnh hùng|vinh hung
yên tâm|yen tam
quý lộc|quy loc
yên trường|yen truong
yên hùng|yen hung
định tăng|dinh tang
định hòa|dinh hoa
định thành|dinh thanh
định tân|dinh tan
định tiến|dinh tien
định long|dinh long
định liên|dinh lien
quán lào|quan lao
định hưng|dinh hung
định hải|dinh hai
định bình|dinh binh
bắc lương|bac luong
thọ hải|tho hai
tây hồ|tay ho
xuân sinh|xuan sinh
xuân hưng|xuan hung
thọ diên|tho dien
thọ lâm|tho lam
xuân bái|xuan bai
sao vàng|sao vang
xuân thiên|xuan thien
thuận minh|thuan minh
thọ lập|tho lap
xuân tín|xuan tin
trường xuân|truong xuan
bát mọt|bat mot
xuân lẹ|xuan le
xuân cao|xuan cao
luận thành|luan thanh
luận khê|luan khe
xuân thắng|xuan thang
thường xuân|thuong xuan
thọ thanh|tho thanh
ngọc phụng|ngoc phung
xuân chinh|xuan chinh
triệu sơn|trieu son
thọ bình|tho binh
thọ tiến|tho tien
triệu thành|trieu thanh
hợp thắng|hop thang
dân lực|dan luc
dân lý|dan ly
an nông|an nong
đồng lợi|dong loi
tiến nông|tien nong
khuyến nông|khuyen nong
xuân thịnh|xuan thinh
thọ dân|tho dan
xuân thọ|xuan tho
thọ tân|tho tan
thọ ngọc|tho ngoc
thọ cường|tho cuong
thọ phú|tho phu
thọ vực|tho vuc
thọ thế|tho the
nông trường|nong truong
thiệu hóa|thieu hoa
thiệu ngọc|thieu ngoc
thiệu vũ|thieu vu
thiệu phúc|thieu phuc
thiệu tiến|thieu tien
thiệu công|thieu cong
thiệu phú|thieu phu
thiệu long|thieu long
thiệu giang|thieu giang
thiệu duy|thieu duy
thiệu nguyên|thieu nguyen
thiệu hợp|thieu hop
thiệu thịnh|thieu thinh
thiệu quang|thieu quang
thiệu thành|thieu thanh
thiệu toán|thieu toan
thiệu chính|thieu chinh
thiệu hòa|thieu hoa
thiệu viên|thieu vien
thiệu lý|thieu ly
thiệu vận|thieu van
thiệu trung|thieu trung
thiệu vân|thieu van
thiệu giao|thieu giao
thiệu khánh|thieu khanh
thiệu dương|thieu duong
bút sơn|but son
hoằng giang|hoang giang
hoằng xuân|hoang xuan
hoằng phượng|hoang phuong
hoằng phú|hoang phu
hoằng quỳ|hoang quy
hoằng kim|hoang kim
hoằng trung|hoang trung
hoằng trinh|hoang trinh
hoằng sơn|hoang son
hoằng cát|hoang cat
hoằng xuyên|hoang xuyen
tào xuyên|tao xuyen
hoằng quý|hoang quy
hoằng hợp|hoang hop
long anh
hoằng quang|hoang quang
hoằng đức|hoang duc
hoằng hà|hoang ha
hoằng đạt|hoang dat
hoằng đạo|hoang dao
hoằng thắng|hoang thang
hoằng đồng|hoang dong
hoằng thái|hoang thai
hoằng thịnh|hoang thinh
hoằng thành|hoang thanh
hoằng lộc|hoang loc
hoằng trạch|hoang trach
hoằng đại|hoang dai
hoằng phong|hoang phong
hoằng lưu|hoang luu
hoằng châu|hoang chau
hoằng tân|hoang tan
hoằng yến|hoang yen
hoằng tiến|hoang tien
hoằng hải|hoang hai
hoằng ngọc|hoang ngoc
hoằng đông|hoang dong
hoằng thanh|hoang thanh
hoằng phụ|hoang phu
hoằng trường|hoang truong
hậu lộc|hau loc
đồng lộc|dong loc
đại lộc|dai loc
triệu lộc|trieu loc
tiến lộc|tien loc
lộc sơn|loc son
cầu lộc|cau loc
thành lộc|thanh loc
phong lộc|phong loc
thuần lộc|thuan loc
hoa lộc|hoa loc
liên lộc|lien loc
quang lộc|quang loc
hòa lộc|hoa loc
minh lộc|minh loc
hưng lộc|hung loc
ngư lộc|ngu loc
nga sơn|nga son
nga vịnh|nga vinh
nga văn|nga van
nga thiện|nga thien
nga tiến|nga tien
nga phượng|nga phuong
nga trung
nga bạch|nga bach
nga thanh
nga yên|nga yen
nga giáp|nga giap
nga hải|nga hai
nga thành|nga thanh
nga an
nga phú|nga phu
nga điền|nga dien
nga tân|nga tan
nga thủy|nga thuy
nga liên|nga lien
nga thái|nga thai
nga thạch|nga thach
nga thắng|nga thang
nga trường|nga truong
yên cát|yen cat
bãi trành|bai tranh
xuân bình|xuan binh
hóa quỳ|hoa quy
cát vân|cat van
cát tân|cat tan
bình lương|binh luong
thanh quân|thanh quan
thanh hòa|thanh hoa
thượng ninh|thuong ninh
bến sung|ben sung
cán khê|can khe
xuân du|xuan du
phượng nghi|phuong nghi
mậu lâm|mau lam
xuân khang|xuan khang
xuân thái|xuan thai
xuân phúc|xuan phuc
thanh kỳ|thanh ky
nông cống|nong cong
tân thọ|tan tho
hoàng sơn|hoang son
tân khang|tan khang
hoàng giang|hoang giang
tế thắng|te thang
tế lợi|te loi
tế nông|te nong
minh nghĩa|minh nghia
minh khôi|minh khoi
vạn hòa|van hoa
trường trung|truong trung
vạn thiện|van thien
trường minh|truong minh
thăng bình|thang binh
công liêm|cong liem
tượng văn|tuong van
thăng thọ|thang tho
tượng sơn|tuong son
công chính|cong chinh
rừng thông|rung thong
đông thanh|dong thanh
đông thịnh|dong thinh
đông văn|dong van
đông nam|dong nam
quảng trạch|quang trach
quảng định|quang dinh
quảng đông|quang dong
quảng nhân|quang nhan
quảng ninh|quang ninh
quảng bình|quang binh
quảng hợp|quang hop
quảng văn|quang van
quảng hòa|quang hoa
quảng trung|quang trung
quảng ngọc|quang ngoc
quảng trường|quang truong
quảng cát|quang cat
quảng phúc|quang phuc
quảng hùng|quang hung
quảng giao|quang giao
quảng tâm|quang tam
quảng thọ|quang tho
quảng vinh|quang vinh
quảng đại|quang dai
quảng hải|quang hai
quảng lưu|quang luu
quảng lộc|quang loc
tiên trang|tien trang
quảng nham|quang nham
quảng thạch|quang thach
quảng thái|quang thai
anh sơn|anh son
ngọc lĩnh|ngoc linh
các sơn|cac son
hải lĩnh|hai linh
hải nhân|hai nhan
trúc lâm|truc lam
hải bình|hai binh
tùng lâm|tung lam
tĩnh hải|tinh hai
trường lâm|truong lam
hải thượng|hai thuong
nghi sơn|nghi son
đông vĩnh|dong vinh
hà huy tập|ha huy tap
quán bàu|quan bau
hưng bình|hung binh
hưng phúc|hung phuc
hưng dũng|hung dung
đội cung|doi cung
lê mao|le mao
bến thủy|ben thuy
trung đô|trung do
nghi phú|nghi phu
hưng đông|hung dong
hưng hòa|hung hoa
vinh tân|vinh tan
nghi thuỷ|nghi thuy
nghi tân|nghi tan
thu thuỷ|thu thuy
nghi hòa|nghi hoa
nghi hải|nghi hai
nghi hương|nghi huong
nghi thu
thông thụ|thong thu
hạnh dịch|hanh dich
nậm giải|nam giai
châu kim|chau kim
mường nọc|muong noc
châu thôn|chau thon
nậm nhoóng|nam nhoong
căm muộn|cam muon
tân lạc|tan lac
châu bính|chau binh
châu thuận|chau thuan
châu hội|chau hoi
châu nga|chau nga
châu tiến|chau tien
châu hạnh|chau hanh
châu thắng|chau thang
châu bình|chau binh
châu hoàn|chau hoan
diên lãm|dien lam
mường xén|muong xen
mỹ lý|my ly
keng đu|keng du
đoọc mạy|dooc may
huồi tụ|huoi tu
mường lống|muong long
na loi
nậm cắn|nam can
bảo nam|bao nam
phà đánh|pha danh
bảo thắng|bao thang
hữu lập|huu lap
tà cạ|ta ca
chiêu lưu|chieu luu
mường típ|muong tip
hữu kiệm|huu kiem
mường ải|muong ai
na ngoi
nậm càn|nam can
thạch giám|thach giam
nhôn mai|nhon mai
hữu khuông|huu khuong
yên tĩnh|yen tinh
xiêng my|xieng my
lưỡng minh|luong minh
yên na|yen na
lưu kiền|luu kien
xá lượng|xa luong
tam thái|tam thai
tam đình|tam dinh
hoà hiếu|hoa hieu
nghĩa đàn|nghia dan
nghĩa mai|nghia mai
nghĩa yên|nghia yen
nghĩa thọ|nghia tho
nghĩa hội|nghia hoi
nghĩa hiếu|nghia hieu
nghĩa tiến|nghia tien
nghĩa mỹ|nghia my
tây hiếu|tay hieu
đông hiếu|dong hieu
nghĩa đức|nghia duc
nghĩa long|nghia long
nghĩa lộc|nghia loc
nghĩa khánh|nghia khanh
quỳ hợp|quy hop
châu hồng|chau hong
đồng hợp|dong hop
châu thành|chau thanh
liên hợp|lien hop
châu lộc|chau loc
châu cường|chau cuong
châu quang|chau quang
thọ hợp|tho hop
minh hợp|minh hop
nghĩa xuân|nghia xuan
châu thái|chau thai
châu đình|chau dinh
văn lợi|van loi
châu lý|chau ly
hạ sơn|ha son
cầu giát|cau giat
quỳnh thắng|quynh thang
quỳnh vinh|quynh vinh
quỳnh lộc|quynh loc
quỳnh thiện|quynh thien
quỳnh lập|quynh lap
quỳnh tân|quynh tan
quỳnh châu|quynh chau
mai hùng|mai hung
quỳnh dị|quynh di
quỳnh xuân|quynh xuan
quỳnh phương|quynh phuong
quỳnh liên|quynh lien
quỳnh văn|quynh van
quỳnh tam|quynh tam
quỳnh thạch|quynh thach
quỳnh bảng|quynh bang
quỳnh thanh|quynh thanh
quỳnh hậu|quynh hau
quỳnh đôi|quynh doi
quỳnh lương|quynh luong
quỳnh yên|quynh yen
quỳnh bá|quynh ba
quỳnh diễn|quynh dien
quỳnh giang|quynh giang
quỳnh nghĩa|quynh nghia
tiến thủy|tien thuy
quỳnh thuận|quynh thuan
quỳnh long|quynh long
tân thắng|tan thang
con cuông|con cuong
bình chuẩn|binh chuan
lạng khê|lang khe
cam lâm|cam lam
thạch ngàn|thach ngan
đôn phục|don phuc
mậu đức|mau duc
chi khê|chi khe
bồng khê|bong khe
yên khê|yen khe
lục dạ|luc da
môn sơn|mon son
giai xuân|giai xuan
nghĩa hợp|nghia hop
nghĩa hoàn|nghia hoan
tiên kỳ|tien ky
nghĩa dũng|nghia dung
nghĩa hành|nghia hanh
đỉnh sơn|dinh son
đức sơn|duc son
tường sơn|tuong son
tào sơn|tao son
lạng sơn|lang son
hội sơn|hoi son
khai sơn|khai son
lĩnh sơn|linh son
diễn châu|dien chau
diễn lâm|dien lam
diễn đoài|dien doai
diễn trường|dien truong
diễn yên|dien yen
diễn hoàng|dien hoang
diễn hùng|dien hung
diễn mỹ|dien my
diễn hồng|dien hong
diễn phong|dien phong
diễn hải|dien hai
diễn tháp|dien thap
diễn liên|dien lien
diễn vạn|dien van
diễn kim|dien kim
diễn kỷ|dien ky
diễn xuân|dien xuan
diễn thái|dien thai
diễn đồng|dien dong
diễn bích|dien bich
diễn hạnh|dien hanh
diễn ngọc|dien ngoc
diễn quảng|dien quang
diễn nguyên|dien nguyen
diễn hoa|dien hoa
diễn thành|dien thanh
diễn phúc|dien phuc
diễn cát|dien cat
diễn thịnh|dien thinh
diễn tân|dien tan
diễn thọ|dien tho
diễn lợi|dien loi
diễn lộc|dien loc
diễn trung|dien trung
diễn an|dien an
diễn phú|dien phu
mã thành|ma thanh
tiến thành|tien thanh
lăng thành|lang thanh
đức thành|duc thanh
kim thành|kim thanh
hậu thành|hau thanh
hùng thành|hung thanh
đô thành|do thanh
thọ thành|tho thanh
tây thành|tay thanh
hồng thành|hong thanh
đồng thành|dong thanh
hoa thành|hoa thanh
tăng thành|tang thanh
văn thành|van thanh
thịnh thành|thinh thanh
bắc thành|bac thanh
nhân thành|nhan thanh
long thành|long thanh
vĩnh thành|vinh thanh
lý thành|ly thanh
viên thành|vien thanh
liên thành|lien thanh
bảo thành|bao thanh
công thành|cong thanh
giang sơn đông|giang son dong
giang sơn tây|giang son tay
bồi sơn|boi son
bài sơn|bai son
tràng sơn|trang son
đặng sơn|dang son
lưu sơn|luu son
đà sơn|da son
lạc sơn|lac son
thịnh sơn|thinh son
thuận sơn|thuan son
nhân sơn|nhan son
hiến sơn|hien son
mỹ sơn|my son
trù sơn|tru son
thanh chương|thanh chuong
cát văn|cat van
thanh nho
hạnh lâm|hanh lam
phong thịnh|phong thinh
thanh tiên|thanh tien
thanh liên|thanh lien
thanh đồng|thanh dong
thanh ngọc|thanh ngoc
thanh lĩnh|thanh linh
thanh chi
xuân tường|xuan tuong
thanh dương|thanh duong
võ liệt|vo liet
thanh khai
quán hành|quan hanh
nghi văn|nghi van
nghi yên|nghi yen
nghi tiến|nghi tien
nghi hưng|nghi hung
nghi đồng|nghi dong
nghi thiết|nghi thiet
nghi lâm|nghi lam
nghi quang
nghi kiều|nghi kieu
nghi mỹ|nghi my
nghi phương|nghi phuong
nghi thuận|nghi thuan
nghi long
nghi xá|nghi xa
nghi hoa
khánh hợp|khanh hop
nghi thịnh|nghi thinh
nghi công bắc|nghi cong bac
nghi công nam|nghi cong nam
nghi thạch|nghi thach
nghi trung
nghi trường|nghi truong
nghi diên|nghi dien
nghi phong
nghi xuân|nghi xuan
nghi liên|nghi lien
nghi vạn|nghi van
nghi ân|nghi an
nghi kim
nghi đức|nghi duc
nghi thái|nghi thai
nam nghĩa|nam nghia
nam anh
nam đàn|nam dan
nam lĩnh|nam linh
thượng tân lộc|thuong tan loc
hồng long|hong long
nam cát|nam cat
khánh sơn|khanh son
trung phúc cường|trung phuc cuong
nam kim
hưng nguyên|hung nguyen
hưng trung|hung trung
hưng yên|hung yen
hưng yên bắc|hung yen bac
hưng tây|hung tay
hưng chính|hung chinh
hưng mỹ|hung my
hưng lĩnh|hung linh
hưng thông|hung thong
hưng tân|hung tan
hưng lợi|hung loi
hưng nghĩa|hung nghia
long xá|long xa
châu nhân|chau nhan
xuân lam|xuan lam
đại nài|dai nai
thạch trung|thach trung
thạch quý|thach quy
thạch linh|thach linh
thạch hạ|thach ha
đồng môn|dong mon
thạch hưng|thach hung
đức thuận|duc thuan
đậu liêu|dau lieu
thuận lộc|thuan loc
phố châu|pho chau
sơn hồng|son hong
sơn tiến|son tien
sơn lâm|son lam
sơn lễ|son le
sơn giang|son giang
sơn lĩnh|son linh
an hòa thịnh|an hoa thinh
sơn tây|son tay
sơn ninh|son ninh
sơn châu|son chau
tân mỹ hà|tan my ha
quang diệm|quang diem
sơn trung|son trung
sơn bằng|son bang
sơn kim 1|son kim 1
sơn kim 2|son kim 2
sơn trà|son tra
sơn long|son long
sơn hàm|son ham
sơn trường|son truong
đức thọ|duc tho
quang vĩnh|quang vinh
tùng châu|tung chau
yên hồ|yen ho
tùng ảnh|tung anh
bùi la nhân|bui la nhan
thanh bình thịnh|thanh binh thinh
lâm trung thủy|lam trung thuy
an dũng|an dung
đức đồng|duc dong
đức lạng|duc lang
vũ quang|vu quang
ân phú|an phu
đức lĩnh|duc linh
thọ điền|tho dien
đức hương|duc huong
đức bồng|duc bong
đức liên|duc lien
hương minh|huong minh
quang thọ|quang tho
xuân hội|xuan hoi
đan trường|dan truong
xuân phổ|xuan pho
xuân hải|xuan hai
tiên điền|tien dien
xuân yên|xuan yen
xuân mỹ|xuan my
cỗ đạm|co dam
xuân liên|xuan lien
xuân lĩnh|xuan linh
cương gián|cuong gian
tân lộc|tan loc
hồng lộc|hong loc
thiên lộc|thien loc
thuần thiện|thuan thien
thịnh lộc|thinh loc
vượng lộc|vuong loc
thanh lộc|thanh loc
kim song trường|kim song truong
thường nga|thuong nga
tùng lộc|tung loc
ích hậu|ich hau
gia hanh
khánh vĩnh yên|khanh vinh yen
trung lộc|trung loc
thượng lộc|thuong loc
hương khê|huong khe
điền mỹ|dien my
hà linh|ha linh
hương thủy|huong thuy
hòa hải|hoa hai
hương giang|huong giang
hương bình|huong binh
hương long|huong long
phú gia|phu gia
gia phố|gia pho
phú phong|phu phong
hương đô|huong do
hương vĩnh|huong vinh
hương xuân|huong xuan
phúc trạch|phuc trach
hương trà|huong tra
hương trạch|huong trach
hương liên|huong lien
thạch hà|thach ha
lộc hà|loc ha
thạch hải|thach hai
thạch mỹ|thach my
thạch kim|thach kim
thạch châu|thach chau
thạch kênh|thach kenh
thạch liên|thach lien
đỉnh bàn|dinh ban
hộ độ|ho do
thạch khê|thach khe
thạch trị|thach tri
thạch lạc|thach lac
thạch ngọc|thach ngoc
thạch văn|thach van
lưu vĩnh sơn|luu vinh son
thạch thắng|thach thang
thạch đài|thach dai
thạch hội|thach hoi
tân lâm hương|tan lam huong
thạch xuân|thach xuan
mai phụ|mai phu
cẩm xuyên|cam xuyen
thiên cầm|thien cam
cẩm dương|cam duong
cẩm vĩnh|cam vinh
cẩm quang|cam quang
cẩm nhượng|cam nhuong
nam phúc thăng|nam phuc thang
cẩm duệ|cam due
cẩm quan|cam quan
cẩm hà|cam ha
cẩm lộc|cam loc
cẩm mỹ|cam my
cẩm lạc|cam lac
cẩm minh|cam minh
hưng trí|hung tri
kỳ xuân|ky xuan
kỳ bắc|ky bac
kỳ phong|ky phong
kỳ tiến|ky tien
kỳ giang|ky giang
kỳ đồng|ky dong
kỳ khang|ky khang
kỳ ninh|ky ninh
kỳ văn|ky van
kỳ trung|ky trung
kỳ thọ|ky tho
kỳ tây|ky tay
kỳ lợi|ky loi
kỳ hải|ky hai
kỳ thư|ky thu
kỳ hà|ky ha
kỳ châu|ky chau
kỳ trinh|ky trinh
kỳ thịnh|ky thinh
kỳ hoa|ky hoa
kỳ phương|ky phuong
kỳ long|ky long
lâm hợp|lam hop
kỳ liên|ky lien
kỳ nam|ky nam
kỳ lạc|ky lac
nam lý|nam ly
đồng hải|dong hai
phú hải|phu hai
bắc nghĩa|bac nghia
đức ninh đông|duc ninh dong
quang phú|quang phu
lộc ninh|loc ninh
bảo ninh|bao ninh
nghĩa ninh|nghia ninh
thuận đức|thuan duc
quy đạt|quy dat
dân hóa|dan hoa
trọng hóa|trong hoa
hóa phúc|hoa phuc
hồng hóa|hong hoa
hóa thanh|hoa thanh
hóa tiến|hoa tien
hóa hợp|hoa hop
xuân hóa|xuan hoa
yên hóa|yen hoa
minh hóa|minh hoa
tân hóa|tan hoa
hóa sơn|hoa son
trung hóa|trung hoa
thượng hóa|thuong hoa
đồng lê|dong le
hương hóa|huong hoa
kim hóa|kim hoa
thanh hóa|thanh hoa
thanh thạch|thanh thach
thuận hóa|thuan hoa
lâm hóa|lam hoa
lê hóa|le hoa
sơn hóa|son hoa
ngư hóa|ngu hoa
thạch hóa|thach hoa
đức hóa|duc hoa
phong hóa|phong hoa
mai hóa|mai hoa
tiến hóa|tien hoa
châu hóa|chau hoa
cao quảng|cao quang
văn hóa|van hoa
ba đồn|ba don
quảng kim|quang kim
quảng tùng|quang tung
cảnh dương|canh duong
quảng xuân|quang xuan
cảnh hóa|canh hoa
liên trường|lien truong
quảng phương|quang phuong
phù hóa|phu hoa
quảng tiên|quang tien
quảng thuận|quang thuan
quảng thủy|quang thuy
hoàn lão|hoan lao
nt việt trung|nt viet trung
xuân trạch|xuan trach
mỹ trạch|my trach
hạ trạch|ha trach
bắc trạch|bac trach
lâm trạch|lam trach
thanh trạch|thanh trach
liên trạch|lien trach
cự nẫm|cu nam
thượng trạch|thuong trach
hưng trạch|hung trach
đồng trạch|dong trach
đức trạch|duc trach
phong nha
vạn trạch|van trach
phú định|phu dinh
trung trạch|trung trach
tây trạch|tay trach
hòa trạch|hoa trach
đại trạch|dai trach
nhân trạch|nhan trach
tân trạch|tan trach
nam trạch|nam trach
lý trạch|ly trach
quán hàu|quan hau
lương ninh|luong ninh
võ ninh|vo ninh
hàm ninh|ham ninh
duy ninh
gia ninh
tân ninh|tan ninh
nt lệ ninh|nt le ninh
kiến giang|kien giang
hồng thủy|hong thuy
ngư thủy bắc|ngu thuy bac
hoa thủy|hoa thuy
an thủy|an thuy
phong thủy|phong thuy
cam thủy|cam thuy
ngân thủy|ngan thuy
lộc thủy|loc thuy
liên thủy|lien thuy
hưng thủy|hung thuy
dương thủy|duong thuy
tân thủy|tan thuy
phú thủy|phu thuy
mỹ thủy|my thuy
ngư thủy|ngu thuy
mai thủy|mai thuy
sen thủy|sen thuy
thái thủy|thai thuy
kim thủy|kim thuy
trường thủy|truong thuy
lâm thủy|lam thuy
đông giang|dong giang
phường 1|phuong 1|p.1|p. 1|p1|p 1
đông lễ|dong le
phường 2|phuong 2|p.2|p. 2|p2|p 2
phường 4|phuong 4|p.4|p. 4|p4|p 4
phường 5|phuong 5|p.5|p. 5|p5|p 5
đông lương|dong luong
phường 3|phuong 3|p.3|p. 3|p3|p 3
an đôn|an don
hồ xá|ho xa
bến quan|ben quan
vĩnh thái|vinh thai
vĩnh tú|vinh tu
vĩnh chấp|vinh chap
trung nam
vĩnh khê|vinh khe
vĩnh thủy|vinh thuy
vĩnh lâm|vinh lam
hiền thành|hien thanh
cửa tùng|cua tung
vĩnh hà|vinh ha
vĩnh giang|vinh giang
vĩnh ô|vinh o
khe sanh
lao bảo|lao bao
hướng lập|huong lap
hướng việt|huong viet
hướng phùng|huong phung
hướng sơn|huong son
hướng linh|huong linh
hướng tân|huong tan
hướng lộc|huong loc
ba tầng|ba tang
a dơi|a doi
gio linh
cửa việt|cua viet
trung giang
trung hải|trung hai
phong bình|phong binh
gio mỹ|gio my
gio hải|gio hai
gio an
gio châu|gio chau
gio việt|gio viet
linh trường|linh truong
gio sơn|gio son
gio mai
hải thái|hai thai
linh hải|linh hai
gio quang
krông klang|krong klang
mò ó|mo o
hướng hiệp|huong hiep
đa krông|da krong
ba lòng|ba long
ba nang
tà long|ta long
húc nghì|huc nghi
a vao
tà rụt|ta rut
a bung
a ngo
cam lộ|cam lo
cam tuyền|cam tuyen
cam thành|cam thanh
cam hiếu|cam hieu
cam chính|cam chinh
cam nghĩa|cam nghia
ái tử|ai tu
triệu an|trieu an
triệu vân|trieu van
triệu phước|trieu phuoc
triệu độ|trieu do
triệu trạch|trieu trach
triệu thuận|trieu thuan
triệu đại|trieu dai
triệu hòa|trieu hoa
triệu lăng|trieu lang
triệu long|trieu long
triệu tài|trieu tai
triệu trung|trieu trung
triệu ái|trieu ai
triệu thượng|trieu thuong
triệu giang|trieu giang
diên sanh|dien sanh
hải ba|hai ba
hải quy|hai quy
hải quế|hai que
hải lệ|hai le
hải dương|hai duong
hải định|hai dinh
hải lâm|hai lam
hải trường|hai truong
hải chánh|hai chanh
hải khê|hai khe
tây lộc|tay loc
phú hậu|phu hau
thuận hòa|thuan hoa
đông ba|dong ba
vỹ dạ|vy da
phường đúc|phuong duc
phú hội|phu hoi
trường an|truong an
phước vĩnh|phuoc vinh
an cựu|an cuu
hương sơ|huong so
thuỷ biều|thuy bieu
thuỷ xuân|thuy xuan
an đông|an dong
an tây|an tay
phong điền|phong dien
điền hương|dien huong
điền môn|dien mon
điền lộc|dien loc
điền hòa|dien hoa
phong chương|phong chuong
điền hải|dien hai
phong hòa|phong hoa
phong thu
phong hiền|phong hien
phong mỹ|phong my
phong an
phong xuân|phong xuan
quảng ngạn|quang ngan
quảng lợi|quang loi
quảng công|quang cong
quảng phước|quang phuoc
thuận an|thuan an
phú thuận|phu thuan
phú dương|phu duong
phú mậu|phu mau
phú an|phu an
phú diên|phu dien
phú hồ|phu ho
vinh xuân|vinh xuan
vinh thanh
vinh an
vinh hà|vinh ha
phú bài|phu bai
thủy vân|thuy van
thủy thanh|thuy thanh
thủy dương|thuy duong
thủy phương|thuy phuong
thủy châu|thuy chau
thủy lương|thuy luong
thủy bằng|thuy bang
thủy tân|thuy tan
thủy phù|thuy phu
dương hòa|duong hoa
tứ hạ|tu ha
hương phong|huong phong
hương toàn|huong toan
hương vân|huong van
hương văn|huong van
hương vinh|huong vinh
hương chữ|huong chu
hương an|huong an
hương hồ|huong ho
hương thọ|huong tho
bình tiến|binh tien
a lưới|a luoi
hồng hạ|hong ha
hồng kim|hong kim
hương nguyên|huong nguyen
hồng bắc|hong bac
quảng nhâm|quang nham
hồng thượng|hong thuong
a roàng|a roang
lâm đớt|lam dot
lăng cô|lang co
vinh mỹ|vinh my
vinh hưng|vinh hung
giang hải|giang hai
vinh hiền|vinh hien
lộc bổn|loc bon
lộc vĩnh|loc vinh
lộc điền|loc dien
lộc trì|loc tri
lộc tiến|loc tien
khe tre
hương phú|huong phu
hương lộc|huong loc
thượng quảng|thuong quang
hương hữu|huong huu
thượng lộ|thuong lo
thượng nhật|thuong nhat
hòa hiệp bắc|hoa hiep bac
hòa hiệp nam|hoa hiep nam
hòa khánh bắc|hoa khanh bac
hòa khánh nam|hoa khanh nam
hòa minh|hoa minh
tam thuận|tam thuan
thanh khê tây|thanh khe tay
thanh khê đông|thanh khe dong
xuân hà|xuan ha
tân chính|tan chinh
chính gián|chinh gian
thạc gián|thac gian
hòa khê|hoa khe
thuận phước|thuan phuoc
thạch thang|thach thang
hải châu i|hai chau i
hải châu ii|hai chau ii
phước ninh|phuoc ninh
hòa thuận tây|hoa thuan tay
hòa thuận đông|hoa thuan dong
bình hiên|binh hien
hòa cường bắc|hoa cuong bac
hòa cường nam|hoa cuong nam
khuê trung|khue trung
thọ quang|tho quang
nại hiên đông|nai hien dong
mân thái|man thai
an hải bắc|an hai bac
phước mỹ|phuoc my
an hải tây|an hai tay
an hải đông|an hai dong
khuê mỹ|khue my
hoà quý|hoa quy
hoà hải|hoa hai
hòa bắc|hoa bac
hòa liên|hoa lien
hòa ninh|hoa ninh
hòa phát|hoa phat
hòa nhơn|hoa nhon
hòa thọ tây|hoa tho tay
hòa thọ đông|hoa tho dong
hòa xuân|hoa xuan
hòa châu|hoa chau
hòa phước|hoa phuoc
hòa khương|hoa khuong
tân thạnh|tan thanh
phước hòa|phuoc hoa
hòa hương|hoa huong
an xuân|an xuan
tam thăng|tam thang
tam thành|tam thanh
tam an
tam phú|tam phu
tam đàn|tam dan
tam lộc|tam loc
tam phước|tam phuoc
tam vinh
tam đại|tam dai
tam ngọc|tam ngoc
tam dân|tam dan
tam lãnh|tam lanh
cẩm phô|cam pho
sơn phong|son phong
cửa đại|cua dai
cẩm an|cam an
cẩm kim|cam kim
cẩm nam|cam nam
cẩm thanh|cam thanh
ga ri
a xan
a nông|a nong
a tiêng|a tieng
bha lê|bha le
a vương|a vuong
p rao
tà lu|ta lu
sông kôn|song kon
jơ ngây|jo ngay
a ting
a rooi
za hung
mà cooi|ma cooi
ka dăng|ka dang
ái nghĩa|ai nghia
đại lãnh|dai lanh
đại hồng|dai hong
đại quang|dai quang
đại hiệp|dai hiep
đại thạnh|dai thanh
đại chánh|dai chanh
đại tân|dai tan
đại phong|dai phong
đại hòa|dai hoa
vĩnh điện|vinh dien
điện tiến|dien tien
điện hòa|dien hoa
điện thắng bắc|dien thang bac
điện thắng trung|dien thang trung
điện thắng nam|dien thang nam
điện ngọc|dien ngoc
điện hồng|dien hong
điện thọ|dien tho
điện phước|dien phuoc
điện an|dien an
điện nam bắc|dien nam bac
điện nam trung|dien nam trung
điện nam đông|dien nam dong
điện dương|dien duong
điện quang|dien quang
điện trung|dien trung
điện phong|dien phong
điện minh|dien minh
điện phương|dien phuong
nam phước|nam phuoc
duy thu
duy phú|duy phu
duy hòa|duy hoa
duy châu|duy chau
duy trinh
duy sơn|duy son
duy trung
duy phước|duy phuoc
duy thành|duy thanh
duy vinh
duy nghĩa|duy nghia
quế xuân 1|que xuan 1
quế xuân 2|que xuan 2
quế phú|que phu
quế trung|que trung
quế hiệp|que hiep
quế thuận|que thuan
quế mỹ|que my
ninh phước|ninh phuoc
quế lộc|que loc
sơn viên|son vien
quế long|que long
quế châu|que chau
quế phong|que phong
quế an|que an
quế minh|que minh
quế lâm|que lam
thạnh mỹ|thanh my
chơ chun|cho chun
tà pơơ|ta poo
la dêê|la dee
đắc tôi|dac toi
chà vàl|cha val
tà bhinh|ta bhinh
cà dy|ca dy
đắc pre|dac pre
đắc pring|dac pring
khâm đức|kham duc
phước xuân|phuoc xuan
phước hiệp|phuoc hiep
phước hoà|phuoc hoa
phước đức|phuoc duc
phước năng|phuoc nang
phước chánh|phuoc chanh
phước công|phuoc cong
phước kim|phuoc kim
phước lộc|phuoc loc
phước thành|phuoc thanh
quế thọ|que tho
bình lâm|binh lam
sông trà|song tra
phước trà|phuoc tra
phước gia|phuoc gia
quế lưu|que luu
thăng phước|thang phuoc
hà lam|ha lam
bình giang|binh giang
bình phục|binh phuc
bình triều|binh trieu
bình đào|binh dao
bình lãnh|binh lanh
bình trị|binh tri
bình định bắc|binh dinh bac
bình định nam|binh dinh nam
bình quý|binh quy
bình chánh|binh chanh
bình tú|binh tu
bình sa|binh sa
bình hải|binh hai
bình quế|binh que
bình nam|binh nam
tiên hà|tien ha
tiên cẩm|tien cam
tiên châu|tien chau
tiên lãnh|tien lanh
tiên ngọc|tien ngoc
tiên cảnh|tien canh
tiên mỹ|tien my
tiên thọ|tien tho
tiên an|tien an
tiên lộc|tien loc
tiên lập|tien lap
trà my|tra my
trà sơn|tra son
trà kót|tra kot
trà nú|tra nu
trà đông|tra dong
trà dương|tra duong
trà bui|tra bui
trà đốc|tra doc
trà tân|tra tan
trà giác|tra giac
trà giáp|tra giap
trà ka|tra ka
trà leng|tra leng
trà dơn|tra don
trà tập|tra tap
trà mai|tra mai
trà cang|tra cang
trà linh|tra linh
trà nam|tra nam
trà don|tra don
trà vân|tra van
trà vinh|tra vinh
núi thành|nui thanh
tam xuân i|tam xuan i
tam xuân ii|tam xuan ii
tam thạnh|tam thanh
tam anh bắc|tam anh bac
tam anh nam
tam hòa|tam hoa
tam hải|tam hai
tam nghĩa|tam nghia
tam mỹ tây|tam my tay
tam mỹ đông|tam my dong
tam trà|tam tra
nghĩa chánh|nghia chanh
nguyễn nghiêm|nguyen nghiem
chánh lộ|chanh lo
nghĩa dõng|nghia dong
châu ổ|chau o
bình thạnh|binh thanh
bình đông|binh dong
bình khương|binh khuong
bình phước|binh phuoc
bình chương|binh chuong
bình hiệp|binh hiep
bình tân phú|binh tan phu
bình châu|binh chau
trà xuân|tra xuan
trà thủy|tra thuy
trà hiệp|tra hiep
trà bình|tra binh
trà phú|tra phu
trà lâm|tra lam
trà bùi|tra bui
trà thanh|tra thanh
trà phong|tra phong
trà xinh|tra xinh
trà tây|tra tay
trương quang trọng|truong quang trong
tịnh thọ|tinh tho
tịnh trà|tinh tra
tịnh phong|tinh phong
tịnh hiệp|tinh hiep
tịnh hòa|tinh hoa
tịnh kỳ|tinh ky
tịnh bình|tinh binh
tịnh đông|tinh dong
tịnh thiện|tinh thien
tịnh ấn đông|tinh an dong
tịnh bắc|tinh bac
tịnh châu|tinh chau
tịnh khê|tinh khe
tịnh long|tinh long
tịnh sơn|tinh son
tịnh hà|tinh ha
tịnh ấn tây|tinh an tay
tịnh giang|tinh giang
tịnh minh|tinh minh
tịnh an|tinh an
la hà|la ha
sông vệ|song ve
nghĩa thắng|nghia thang
nghĩa kỳ|nghia ky
nghĩa hà|nghia ha
nghĩa điền|nghia dien
nghĩa thương|nghia thuong
di lăng|di lang
sơn hạ|son ha
sơn nham|son nham
sơn bao|son bao
sơn linh|son linh
sơn thượng|son thuong
sơn cao|son cao
sơn kỳ|son ky
sơn ba|son ba
sơn bua|son bua
sơn mùa|son mua
sơn liên|son lien
sơn tân|son tan
sơn màu|son mau
sơn dung|son dung
sơn tinh|son tinh
long mai
long môn|long mon
long hiệp|long hiep
chợ chùa|cho chua
hành thuận|hanh thuan
hành dũng|hanh dung
hành trung|hanh trung
hành nhân|hanh nhan
hành đức|hanh duc
hành minh|hanh minh
hành phước|hanh phuoc
hành thiện|hanh thien
hành thịnh|hanh thinh
hành tín tây|hanh tin tay
hành tín đông|hanh tin dong
mộ đức|mo duc
đức lợi|duc loi
đức nhuận|duc nhuan
đức chánh|duc chanh
đức hiệp|duc hiep
đức minh|duc minh
đức thạnh|duc thanh
đức hòa|duc hoa
đức tân|duc tan
đức phú|duc phu
đức phong|duc phong
đức lân|duc lan
phổ an|pho an
phổ phong|pho phong
phổ thuận|pho thuan
phổ văn|pho van
phổ quang|pho quang
phổ nhơn|pho nhon
phổ ninh|pho ninh
phổ minh|pho minh
phổ vinh|pho vinh
phổ hòa|pho hoa
phổ cường|pho cuong
phổ khánh|pho khanh
phổ thạnh|pho thanh
phổ châu|pho chau
ba tơ|ba to
ba điền|ba dien
ba vinh
ba thành|ba thanh
ba động|ba dong
ba dinh
ba giang
ba liên|ba lien
ba ngạc|ba ngac
ba khâm|ba kham
ba cung
ba tiêu|ba tieu
ba trang
ba tô|ba to
ba bích|ba bich
ba lế|ba le
ba nam
ba xa
nhơn bình|nhon binh
nhơn phú|nhon phu
trần quang diệu|tran quang dieu
hải cảng|hai cang
thị nại|thi nai
ngô mây|ngo may
bùi thị xuân|bui thi xuan
nguyễn văn cừ|nguyen van cu
ghềnh ráng|ghenh rang
nhơn lý|nhon ly
nhơn hội|nhon hoi
nhơn hải|nhon hai
nhơn châu|nhon chau
an trung
an toàn|an toan
an quang
an nghĩa|an nghia
bồng sơn|bong son
hoài sơn|hoai son
hoài châu bắc|hoai chau bac
hoài châu|hoai chau
hoài phú|hoai phu
tam quan bắc|tam quan bac
tam quan nam
hoài hảo|hoai hao
hoài thanh tây|hoai thanh tay
hoài thanh|hoai thanh
hoài hương|hoai huong
hoài tân|hoai tan
hoài hải|hoai hai
hoài xuân|hoai xuan
hoài mỹ|hoai my
hoài đức|hoai duc
tăng bạt hổ|tang bat ho
ân hảo tây|an hao tay
ân hảo đông|an hao dong
ân sơn|an son
ân mỹ|an my
đak mang|dak mang
ân tín|an tin
ân thạnh|an thanh
ân phong|an phong
ân đức|an duc
ân hữu|an huu
bok tới|bok toi
ân tường tây|an tuong tay
ân tường đông|an tuong dong
phù mỹ|phu my
mỹ châu|my chau
mỹ lợi|my loi
mỹ phong|my phong
mỹ trinh|my trinh
mỹ thọ|my tho
mỹ chánh|my chanh
mỹ quang|my quang
mỹ hiệp|my hiep
mỹ tài|my tai
mỹ cát|my cat
mỹ chánh tây|my chanh tay
vĩnh thạnh|vinh thanh
vĩnh kim|vinh kim
vĩnh hiệp|vinh hiep
vĩnh thuận|vinh thuan
bình tân|binh tan
tây thuận|tay thuan
tây an|tay an
tây bình|tay binh
bình tường|binh tuong
tây vinh|tay vinh
tây xuân|tay xuan
bình nghi|binh nghi
tây phú|tay phu
cát sơn|cat son
cát minh|cat minh
cát khánh|cat khanh
cát tài|cat tai
cát lâm|cat lam
cát hanh|cat hanh
cát trinh|cat trinh
cát hiệp|cat hiep
cát nhơn|cat nhon
cát hưng|cat hung
cát tường|cat tuong
cát tiến|cat tien
cát thắng|cat thang
cát chánh|cat chanh
đập đá|dap da
nhơn mỹ|nhon my
nhơn thành|nhon thanh
nhơn hạnh|nhon hanh
nhơn hậu|nhon hau
nhơn phong|nhon phong
nhơn an|nhon an
nhơn phúc|nhon phuc
nhơn hưng|nhon hung
nhơn khánh|nhon khanh
nhơn lộc|nhon loc
nhơn hoà|nhon hoa
nhơn tân|nhon tan
nhơn thọ|nhon tho
tuy phước|tuy phuoc
diêu trì|dieu tri
phước thắng|phuoc thang
phước hưng|phuoc hung
phước quang|phuoc quang
phước sơn|phuoc son
phước nghĩa|phuoc nghia
phước thuận|phuoc thuan
phước an|phuoc an
canh liên|canh lien
canh hiệp|canh hiep
canh vinh
canh hiển|canh hien
canh thuận|canh thuan
canh hòa|canh hoa
phường 8|phuong 8|p.8|p. 8|p8|p 8
phường 9|phuong 9|p.9|p. 9|p9|p 9
phường 7|phuong 7|p.7|p. 7|p7|p 7
phường 6|phuong 6|p.6|p. 6|p6|p 6
phú thạnh|phu thanh
hòa kiến|hoa kien
bình kiến|binh kien
xuân cảnh|xuan canh
xuân thọ 1|xuan tho 1
xuân thọ 2|xuan tho 2
la hai
phú mỡ|phu mo
xuân lãnh|xuan lanh
xuân quang 1|xuan quang 1
xuân sơn bắc|xuan son bac
xuân quang 2|xuan quang 2
xuân sơn nam|xuan son nam
xuân quang 3|xuan quang 3
xuân phước|xuan phuoc
chí thạnh|chi thanh
an dân|an dan
an ninh tây|an ninh tay
an ninh đông|an ninh dong
an thạch|an thach
an định|an dinh
an nghiệp|an nghiep
an cư|an cu
an lĩnh|an linh
an hòa hải|an hoa hai
an chấn|an chan
củng sơn|cung son
phước tân|phuoc tan
sơn hội|son hoi
sơn định|son dinh
cà lúi|ca lui
sơn phước|son phuoc
sơn xuân|son xuan
sơn nguyên|son nguyen
eachà rang|eacha rang
krông pa|krong pa
suối bạc|suoi bac
suối trai|suoi trai
hai riêng|hai rieng
ea lâm|ea lam
đức bình tây|duc binh tay
ea bá|ea ba
đức bình đông|duc binh dong
sông hinh|song hinh
hòa thành|hoa thanh
sơn thành tây|son thanh tay
sơn thành đông|son thanh dong
hòa bình 1|hoa binh 1
hoà vinh|hoa vinh
hoà hiệp trung|hoa hiep trung
hòa tân đông|hoa tan dong
hòa tân tây|hoa tan tay
hòa đồng|hoa dong
hòa xuân tây|hoa xuan tay
hòa mỹ đông|hoa my dong
hòa mỹ tây|hoa my tay
hòa xuân đông|hoa xuan dong
hòa thịnh|hoa thinh
hòa tâm|hoa tam
hòa xuân nam|hoa xuan nam
hòa quang bắc|hoa quang bac
hòa quang nam|hoa quang nam
hòa hội|hoa hoi
hòa trị|hoa tri
hòa định đông|hoa dinh dong
phú hoà|phu hoa
hòa định tây|hoa dinh tay
vĩnh hải|vinh hai
vĩnh phước|vinh phuoc
ngọc hiệp|ngoc hiep
vĩnh thọ|vinh tho
xương huân|xuong huan
vạn thạnh|van thanh
phương sài|phuong sai
phước hải|phuoc hai
lộc thọ|loc tho
phước tiến|phuoc tien
vĩnh nguyên|vinh nguyen
phước long|phuoc long
vĩnh trường|vinh truong
vĩnh lương|vinh luong
vĩnh phương|vinh phuong
phước đồng|phuoc dong
cam phúc bắc|cam phuc bac
cam phúc nam|cam phuc nam
cam lộc|cam loc
cam phú|cam phu
ba ngòi|ba ngoi
cam thuận|cam thuan
cam lợi|cam loi
cam linh
cam tân|cam tan
cam hòa|cam hoa
cam hải đông|cam hai dong
cam hải tây|cam hai tay
cam hiệp bắc|cam hiep bac
cam đức|cam duc
cam hiệp nam|cam hiep nam
cam phước tây|cam phuoc tay
cam thành bắc|cam thanh bac
cam an bắc|cam an bac
cam thành nam|cam thanh nam
cam an nam
cam phước đông|cam phuoc dong
cam thịnh tây|cam thinh tay
cam thịnh đông|cam thinh dong
cam lập|cam lap
cam bình|cam binh
vạn giã|van gia
vạn phước|van phuoc
vạn long|van long
vạn bình|van binh
vạn khánh|van khanh
vạn phú|van phu
vạn lương|van luong
vạn hưng|van hung
ninh tây|ninh tay
ninh thượng|ninh thuong
ninh thọ|ninh tho
ninh trung
ninh sim
ninh thân|ninh than
ninh diêm|ninh diem
ninh đông|ninh dong
ninh thủy|ninh thuy
ninh đa|ninh da
ninh phụng|ninh phung
ninh bình|ninh binh
ninh phú|ninh phu
ninh tân|ninh tan
ninh quang
ninh hà|ninh ha
ninh hưng|ninh hung
ninh lộc|ninh loc
ninh ích|ninh ich
khánh vĩnh|khanh vinh
khánh hiệp|khanh hiep
khánh bình|khanh binh
khánh đông|khanh dong
khánh nam|khanh nam
giang ly
cầu bà|cau ba
liên sang|lien sang
sơn thái|son thai
diên khánh|dien khanh
diên lâm|dien lam
diên điền|dien dien
diên xuân|dien xuan
diên sơn|dien son
diên đồng|dien dong
diên phú|dien phu
diên thọ|dien tho
diên phước|dien phuoc
diên lạc|dien lac
diên tân|dien tan
diên hòa|dien hoa
diên thạnh|dien thanh
diên toàn|dien toan
diên an|dien an
bình lộc|binh loc
suối hiệp|suoi hiep
suối tiên|suoi tien
suối cát|suoi cat
suối tân|suoi tan
tô hạp|to hap
sơn hiệp|son hiep
ba cụm bắc|ba cum bac
ba cụm nam|ba cum nam
trường sa|truong sa
song tử tây|song tu tay
đô vinh|do vinh
sinh tồn|sinh ton
bảo an|bao an
phủ hà|phu ha
tấn tài|tan tai
kinh dinh
đạo long|dao long
đài sơn|dai son
mỹ đông|my dong
thành hải|thanh hai
mỹ bình|my binh
mỹ hải|my hai
phước bình|phuoc binh
phước đại|phuoc dai
phước chính|phuoc chinh
phước trung|phuoc trung
ma nới|ma noi
nhơn sơn|nhon son
phước chiến|phuoc chien
công hải|cong hai
phước kháng|phuoc khang
lợi hải|loi hai
phương hải|phuong hai
tân hải|tan hai
hộ hải|ho hai
tri hải|tri hai
phước dân|phuoc dan
phước thái|phuoc thai
phước hậu|phuoc hau
phước hà|phuoc ha
an hải|an hai
phước hữu|phuoc huu
phước nam|phuoc nam
nhị hà|nhi ha
phước dinh|phuoc dinh
phước minh|phuoc minh
phước diêm|phuoc diem
cà ná|ca na
phước vinh|phuoc vinh
mũi né|mui ne
hàm tiến|ham tien
phú hài|phu hai
phú tài|phu tai
phú trinh|phu trinh
bình hưng|binh hung
đức nghĩa|duc nghia
thiện nghiệp|thien nghiep
phong nẫm|phong nam
tiến lợi|tien loi
liên hương|lien huong
phan rí cửa|phan ri cua
phan dũng|phan dung
vĩnh tân|vinh tan
phước thể|phuoc the
chí công|chi cong
chợ lầu|cho lau
phan sơn|phan son
phan lâm|phan lam
phan điền|phan dien
sông lũy|song luy
phan tiến|phan tien
sông bình|song binh
phan hòa|phan hoa
phan hiệp|phan hiep
phan rí thành|phan ri thanh
ma lâm|ma lam
la dạ|la da
hàm phú|ham phu
hồng liêm|hong liem
hàm trí|ham tri
hàm đức|ham duc
hàm liêm|ham liem
hàm chính|ham chinh
hàm hiệp|ham hiep
hàm thắng|ham thang
đa mi|da mi
thuận nam|thuan nam
mỹ thạnh|my thanh
hàm cần|ham can
mương mán|muong man
hàm thạnh|ham thanh
hàm kiệm|ham kiem
hàm cường|ham cuong
hàm mỹ|ham my
hàm minh|ham minh
thuận quí|thuan qui
tân thuận|tan thuan
lạc tánh|lac tanh
bắc ruộng|bac ruong
nghị đức|nghi duc
la ngâu|la ngau
huy khiêm|huy khiem
măng tố|mang to
đồng kho|dong kho
gia an
đức bình|duc binh
gia huynh
suối kiết|suoi kiet
võ xu|vo xu
đức tài|duc tai
đa kai|da kai
sùng nhơn|sung nhon
mê pu|me pu
đức tín|duc tin
vũ hoà|vu hoa
phước hội|phuoc hoi
tân thiện|tan thien
tân nghĩa|tan nghia
sông phan|song phan
thắng hải|thang hai
sơn mỹ|son my
tân phước|tan phuoc
ngũ phụng|ngu phung
long hải|long hai
trường chinh|truong chinh
đắk cấm|dak cam
ngọk bay|ngok bay
đắk blà|dak bla
ia chim
đăk năng|dak nang
chư hreng|chu hreng
đắk rơ wa|dak ro wa
đắk glei|dak glei
đắk blô|dak blo
đắk man|dak man
đắk nhoong|dak nhoong
đắk pék|dak pek
đắk choong|dak choong
mường hoong|muong hoong
đắk long|dak long
đắk kroong|dak kroong
đắk môn|dak mon
plei kần|plei kan
đắk ang|dak ang
đắk dục|dak duc
đắk nông|dak nong
đắk xú|dak xu
đắk kan|dak kan
bờ y|bo y
sa loong
đắk tô|dak to
ngọc lây|ngoc lay
đắk na|dak na
măng ri|mang ri
ngọc yêu|ngoc yeu
đắk sao|dak sao
đắk rơ ông|dak ro ong
đắk tờ kan|dak to kan
tu mơ rông|tu mo rong
đắk hà|dak ha
đắk rơ nga|dak ro nga
ngọk tụ|ngok tu
đắk trăm|dak tram
văn lem|van lem
kon đào|kon dao
tân cảnh|tan canh
diên bình|dien binh
pô kô|po ko
tê xăng|te xang
văn xuôi|van xuoi
đắk nên|dak nen
đắk ring|dak ring
măng buk|mang buk
đắk tăng|dak tang
ngok tem
pờ ê|po e
măng cành|mang canh
măng đen|mang den
đắk rve|dak rve
đắk kôi|dak koi
đắk tơ lung|dak to lung
đắk ruồng|dak ruong
đắk pne|dak pne
đắk tờ re|dak to re
đắk pxi|dak pxi
đăk long|dak long
đắk hring|dak hring
đắk ui|dak ui
đăk ngọk|dak ngok
đắk mar|dak mar
ngok wang
ngok réo|ngok reo
hà mòn|ha mon
đắk la|dak la
sa thầy|sa thay
rơ kơi|ro koi
sa nhơn|sa nhon
hơ moong|ho moong
ia đal|ia dal
mô rai|mo rai
ia dom
ia tơi|ia toi
sa sơn|sa son
sa nghĩa|sa nghia
sa bình|sa binh
ya xiêr|ya xier
ya tăng|ya tang
ya ly
yên đỗ|yen do
diên hồng|dien hong
ia kring
hội thương|hoi thuong
hội phú|hoi phu
hoa lư|hoa lu
trà bá|tra ba
biển hồ|bien ho
trà đa|tra da
chư á|chu a
ia kênh|ia kenh
tú an|tu an
cửu an|cuu an
an phước|an phuoc
kon pne
đăk roong|dak roong
sơn lang|son lang
sơ pai|so pai
lơ ku|lo ku
đak smar|dak smar
tơ tung|to tung
kông lơng khơng|kong long khong
kông pla|kong pla
đăk hlơ|dak hlo
đăk đoa|dak doa
đăk sơmei|dak somei
đăk krong|dak krong
hải yang|hai yang
kon gang
hà bầu|ha bau
nam yang
k' dang|k  dang
h' neng|h  neng
a dơk|a dok
ia pết|ia pet
ia băng|ia bang
hà tây|ha tay
ia khươl|ia khuol
ia phí|ia phi
ia ly
ia mơ nông|ia mo nong
ia kreng
đăk tơ ver|dak to ver
chư đăng ya|chu dang ya
ia ka
ia nhin
ia kha
ia sao
ia yok
ia hrung
ia bă|ia ba
ia khai
ia krai
ia grăng|ia grang
ia tô|ia to
ia o
ia dêr|ia der
ia chia
ia pếch|ia pech
kon dơng|kon dong
đak jơ ta|dak jo ta
đak ta ley|dak ta ley
đăk yă|dak ya
đăk djrăng|dak djrang
lơ pang|lo pang
kon thụp|kon thup
đê ar|de ar
kon chiêng|kon chieng
đăk trôi|dak troi
kông chro|kong chro
chư krêy|chu krey
kông yang|kong yang
đăk tơ pang|dak to pang
đắk kơ ning|dak ko ning
đăk song|dak song
đăk pling|dak pling
yang trung
đăk pơ pho|dak po pho
ya ma
chơ long|cho long
yang nam
chư ty|chu ty
ia dơk|ia dok
ia krêl|ia krel
ia din
ia kla
ia lang
ia kriêng|ia krieng
ia pnôn|ia pnon
ia nan
chư prông|chu prong
ia kly
bình giáo|binh giao
ia drăng|ia drang
thăng hưng|thang hung
bàu cạn|bau can
ia phìn|ia phin
ia tôr|ia tor
ia boòng|ia boong
ia púch|ia puch
ia me
ia vê|ia ve
ia bang
ia pia
ia ga
ia lâu|ia lau
ia piơr|ia pior
ia mơ|ia mo
chư sê|chu se
ia tiêm|ia tiem
chư pơng|chu pong
bar măih|bar maih
bờ ngoong|bo ngoong
ia glai
al bá|al ba
kông htok|kong htok
ia hlốp|ia hlop
ia blang
ia pal
h bông|h bong
ia hrú|ia hru
ia rong
ia dreng
ia ko
ia hla
chư don|chu don
ia phang
ia le
ia blứ|ia blu
hà tam|ha tam
an thành|an thanh
đak pơ|dak po
yang bắc|yang bac
cư an|cu an
ya hội|ya hoi
pờ tó|po to
chư răng|chu rang
ia kdăm|ia kdam
chư mố|chu mo
ia tul
ia ma rơn|ia ma ron
ia broăi|ia broai
ia trok
cheo reo
phú thiện|phu thien
sông bờ|song bo
chư a thai|chu a thai
ayun hạ|ayun ha
ia ake
ia sol
ia piar
ia peng
chrôh pơnan|chroh ponan
ia hiao
ia rbol
chư băh|chu bah
ia yeng
ia rtô|ia rto
ia rsai
ia rsươm|ia rsuom
chư gu|chu gu
đất bằng|dat bang
ia mláh|ia mlah
chư drăng|chu drang
phú cần|phu can
ia hdreh
ia rmok
chư ngọc|chu ngoc
chư rcăm|chu rcam
krông năng|krong nang
thành nhất|thanh nhat
tự an|tu an
ea tam
hòa thuận|hoa thuan
cư êbur|cu ebur
ea tu
ea kao
hòa khánh|hoa khanh
ea drăng|ea drang
ea h'leo|ea h leo
ea sol
ea ral
ea wy
cư a mung|cu a mung
cư mốt|cu mot
ea hiao
ea khal
dliê yang|dlie yang
ea tir
ea nam
ea súp|ea sup
ia lốp|ia lop
ia jlơi|ia jloi
ea rốk|ea rok
ya tờ mốt|ya to mot
ia rvê|ia rve
ea lê|ea le
cư kbang|cu kbang
ea bung
cư m'lan|cu m lan
krông na|krong na
ea huar
ea wer
tân hoà|tan hoa
cuôr knia|cuor knia
ea bar
ea nuôl|ea nuol
ea pốk|ea pok
ea kuêh|ea kueh
ea kiết|ea kiet
ea tar
cư dliê m'nông|cu dlie m nong
ea h'đinh|ea h dinh
ea tul
ea kpam
ea m'dróh|ea m droh
quảng hiệp|quang hiep
cư m'gar|cu m gar
ea d'rơng|ea d rong
ea m'nang|ea m nang
cư suê|cu sue
cuor đăng|cuor dang
cư né|cu ne
chư kbô|chu kbo
thiện an|thien an
cư pơng|cu pong
ea sin
pơng drang|pong drang
đạt hiếu|dat hieu
ea ngai
ea blang
ea drông|ea drong
ea siên|ea sien
cư bao|cu bao
đliê ya|dlie ya
ea tóh|ea toh
ea puk
ea dăh|ea dah
ea hồ|ea ho
cư klông|cu klong
ea tân|ea tan
ea kar
ea knốp|ea knop
ea sô|ea so
ea sar
cư huê|cu hue
ea tih
ea đar|ea dar
ea kmút|ea kmut
cư ni|cu ni
ea păl|ea pal
cư prông|cu prong
ea ô|ea o
cư elang|cu elang
cư bông|cu bong
cư jang|cu jang
cư prao|cu prao
ea pil
ea lai
ea h'mlay|ea h mlay
krông jing|krong jing
ea m' doal|ea m  doal
ea riêng|ea rieng
cư m'ta|cu m ta
cư k róa|cu k roa
krông á|krong a
cư san|cu san
ea trang
krông kmar|krong kmar
dang kang
cư kty|cu kty
hòa tân|hoa tan
hòa lễ|hoa le
yang reh
ea trul
khuê ngọc điền|khue ngoc dien
cư pui|cu pui
cư drăm|cu dram
yang mao
krông búk|krong buk
ea kly
ea kênh|ea kenh
ea phê|ea phe
ea knuec
ea yông|ea yong
ea kuăng|ea kuang
hòa đông|hoa dong
ea hiu
vụ bổn|vu bon
ea uy
ea yiêng|ea yieng
buôn trấp|buon trap
ea ning
cư ê wi|cu e wi
ea ktur
ea tiêu|ea tieu
ea bhốk|ea bhok
ea hu
dray sáp|dray sap
ea na
dray bhăng|dray bhang
hòa hiệp|hoa hiep
ea bông|ea bong
băng a drênh|bang a drenh
dur kmăl|dur kmal
quảng điền|quang dien
yang tao
bông krang|bong krang
đắk liêng|dak lieng
buôn triết|buon triet
buôn tría|buon tria
đắk phơi|dak phoi
đắk nuê|dak nue
krông nô|krong no
nam ka
ea r'bin|ea r bin
đăk r'moan|dak r moan
quảng hoà|quang hoa
đắk ha|dak ha
đắk r'măng|dak r mang
đắk nia|dak nia
đắk plao|dak plao
đắk som|dak som
ea t'ling|ea t ling
đắk wil|dak wil
ea pô|ea po
nam dong
đắk drông|dak drong
tâm thắng|tam thang
cư knia|cu knia
trúc sơn|truc son
đắk mil|dak mil
đắk lao|dak lao
đắk r'la|dak r la
đắk gằn|dak gan
đức mạnh|duc manh
đắk n'drót|dak n drot
đắk sắk|dak sak
đắk mâm|dak mam
đắk sôr|dak sor
buôn choah|buon choah
nam đà|nam da
đắk drô|dak dro
nâm nung|nam nung
đức xuyên|duc xuyen
đắk nang|dak nang
nâm n'đir|nam n dir
đức an|duc an
đắk môl|dak mol
đắk hòa|dak hoa
thuận hà|thuan ha
thuận hạnh|thuan hanh
đắk n'dung|dak n dung
nâm n'jang|nam n jang
kiến đức|kien duc
quảng trực|quang truc
đắk búk so|dak buk so
đắk r'tíh|dak r tih
quảng tín|quang tin
đắk ngo|dak ngo
đắk wer|dak wer
nhân cơ|nhan co
kiến thành|kien thanh
đạo nghĩa|dao nghia
đắk sin|dak sin
đắk ru|dak ru
phường 12|phuong 12|p.12|p. 12|p12|p 12
phường 10|phuong 10|p.10|p. 10|p10|p 10
phường 11|phuong 11|p.11|p. 11|p11|p 11
tà nung|ta nung
trạm hành|tram hanh
lộc phát|loc phat
đạm bri|dam bri
lộc thanh|loc thanh
lộc nga|loc nga
lộc châu|loc chau
đại lào|dai lao
lạc dương|lac duong
đạ chais|da chais
đạ nhim|da nhim
đưng knớ|dung kno
đạ tông|da tong
đạ long|da long
đạ m' rong|da m  rong
đạ sar|da sar
nam ban
đinh văn|dinh van
liêng srônh|lieng sronh
đạ rsal|da rsal
rô men|ro men
phi tô|phi to
phi liêng|phi lieng
đạ k' nàng|da k  nang
đạ đờn|da don
lạc xuân|lac xuan
đạ ròn|da ron
lạc lâm|lac lam
ka đô|ka do
quảng lập|quang lap
ka đơn|ka don
tu tra
hiệp thạnh|hiep thanh
n'thol hạ|n thol ha
ninh gia
tà năng|ta nang
đa quyn|da quyn
tà hine|ta hine
đà loan|da loan
ninh loan
di linh
đinh trang thượng|dinh trang thuong
tân lâm|tan lam
gia hiệp|gia hiep
đinh lạc|dinh lac
tam bố|tam bo
đinh trang hòa|dinh trang hoa
liên đầm|lien dam
gung ré|gung re
bảo thuận|bao thuan
hòa trung|hoa trung
sơn điền|son dien
gia bắc|gia bac
lộc thắng|loc thang
lộc bảo|loc bao
lộc lâm|loc lam
lộc phú|loc phu
lộc bắc|loc bac
b' lá|b  la
lộc ngãi|loc ngai
lộc quảng|loc quang
lộc tân|loc tan
lộc đức|loc duc
lộc thành|loc thanh
lộc nam|loc nam
đạ m'ri|da m ri
ma đa guôi|ma da guoi
hà lâm|ha lam
đạ tồn|da ton
đạ oai|da oai
đạ ploa|da ploa
đạ tẻh|da teh
an nhơn|an nhon
quảng trị|quang tri
đạ lây|da lay
triệu hải|trieu hai
đạ kho|da kho
đạ pal|da pal
cát tiên|cat tien
tiên hoàng|tien hoang
phước cát 2|phuoc cat 2
gia viễn|gia vien
nam ninh
phước cát|phuoc cat
đức phổ|duc pho
quảng ngãi|quang ngai
đồng nai thượng|dong nai thuong
tiến hưng|tien hung
thác mơ|thac mo
long thủy|long thuy
long phước|long phuoc
bù gia mập|bu gia map
đak ơ|dak o
phú văn|phu van
đa kia|da kia
bình thắng|binh thang
long bình|long binh
long giang
phước tín|phuoc tin
bù nho|bu nho
long hà|long ha
long tân|long tan
phú trung|phu trung
phú riềng|phu rieng
lộc tấn|loc tan
lộc thạnh|loc thanh
lộc hiệp|loc hiep
lộc thiện|loc thien
lộc thuận|loc thuan
lộc quang|loc quang
lộc thái|loc thai
lộc hưng|loc hung
lộc khánh|loc khanh
hưng phước|hung phuoc
phước thiện|phuoc thien
thiện hưng|thien hung
hưng chiến|hung chien
an lộc|an loc
phú đức|phu duc
an khương|an khuong
thanh phú|thanh phu
tân khai|tan khai
đồng nơ|dong no
thuận lợi|thuan loi
thuận phú|thuan phu
đường 10|duong 10
đak nhau|dak nhau
bom bo
minh hưng|minh hung
đồng nai|dong nai
đức liễu|duc lieu
đăng hà|dang ha
chơn thành|chon thanh
tân quan|tan quan
nha bích|nha bich
minh thắng|minh thang
hiệp ninh|hiep ninh
thạnh tân|thanh tan
ninh thạnh|ninh thanh
tân biên|tan bien
thạnh bắc|thanh bac
thạnh bình|thanh binh
thạnh tây|thanh tay
mỏ công|mo cong
trà vong|tra vong
tân đông|tan dong
suối ngô|suoi ngo
suối dây|suoi day
thạnh đông|thanh dong
dương minh châu|duong minh chau
suối đá|suoi da
bàu năng|bau nang
chà là|cha la
cầu khởi|cau khoi
bến củi|ben cui
truông mít|truong mit
hảo đước|hao duoc
đồng khởi|dong khoi
an cơ|an co
biên giới|bien gioi
hòa thạnh|hoa thanh
trí bình|tri binh
thanh điền|thanh dien
ninh điền|ninh dien
long vĩnh|long vinh
long hoa
hiệp tân|hiep tan
long thành bắc|long thanh bac
trường hòa|truong hoa
trường đông|truong dong
long thành trung|long thanh trung
trường tây|truong tay
long thành nam|long thanh nam
gò dầu|go dau
thạnh đức|thanh duc
bàu đồn|bau don
phước thạnh|phuoc thanh
phước đông|phuoc dong
phước trạch|phuoc trach
thanh phước|thanh phuoc
bến cầu|ben cau
long chữ|long chu
tiên thuận|tien thuan
long khánh|long khanh
lợi thuận|loi thuan
long thuận|long thuan
an thạnh|an thanh
trảng bàng|trang bang
đôn thuận|don thuan
hưng thuận|hung thuan
an tịnh|an tinh
phước chỉ|phuoc chi
hiệp thành|hiep thanh
phú lợi|phu loi
phú thọ|phu tho
chánh nghĩa|chanh nghia
định hoà|dinh hoa
hoà phú|hoa phu
phú tân|phu tan
tương bình hiệp|tuong binh hiep
chánh mỹ|chanh my
dầu tiếng|dau tieng
minh hoà|minh hoa
minh thạnh|minh thanh
định an|dinh an
long hoà|long hoa
định hiệp|dinh hiep
an lập|an lap
mỹ phước|my phuoc
trừ văn thố|tru van tho
cây trường ii|cay truong ii
lai uyên|lai uyen
long nguyên|long nguyen
lai hưng|lai hung
chánh phú hòa|chanh phu hoa
an điền|an dien
thới hòa|thoi hoa
hòa lợi|hoa loi
tân định|tan dinh
an linh
phước sang|phuoc sang
an long
tam lập|tam lap
vĩnh hoà|vinh hoa
uyên hưng|uyen hung
tân phước khánh|tan phuoc khanh
đất cuốc|dat cuoc
hiếu liêm|hieu liem
lạc an|lac an
hội nghĩa|hoi nghia
phú chánh|phu chanh
thường tân|thuong tan
tân vĩnh hiệp|tan vinh hiep
thạnh phước|thanh phuoc
thạnh hội|thanh hoi
dĩ an|di an
tân đông hiệp|tan dong hiep
lái thiêu|lai thieu
thuận giao|thuan giao
hưng định|hung dinh
bình nhâm|binh nham
vĩnh phú|vinh phu
trảng dài|trang dai
hố nai|ho nai
bửu long|buu long
bình đa|binh da
bửu hòa|buu hoa
long bình tân|long binh tan
tân vạn|tan van
tân hạnh|tan hanh
hóa an|hoa an
xuân thanh|xuan thanh
bảo quang|bao quang
suối tre|suoi tre
bảo vinh|bao vinh
bàu sen|bau sen
bàu trâm|bau tram
hàng gòn|hang gon
dak lua
nam cát tiên|nam cat tien
núi tượng|nui tuong
tà lài|ta lai
phú lập|phu lap
phú lý|phu ly
trị an|tri an
bình lợi|binh loi
thạnh phú|thanh phu
mã đà|ma da
định quán|dinh quan
ngọc định|ngoc dinh
la ngà|la nga
gia canh
phú ngọc|phu ngoc
túc trưng|tuc trung
suối nho|suoi nho
trảng bom|trang bom
cây gáo|cay gao
bàu hàm|bau ham
sông thao|song thao
sông trầu|song trau
đông hoà|dong hoa
hố nai 3|ho nai 3
tây hoà|tay hoa
đồi 61|doi 61
giang điền|giang dien
an viễn|an vien
gia tân 1|gia tan 1
gia tân 2|gia tan 2
gia tân 3|gia tan 3
gia kiệm|gia kiem
bàu hàm 2|bau ham 2
lộ 25|lo 25
xuân thiện|xuan thien
dầu giây|dau giay
sông nhạn|song nhan
xuân quế|xuan que
xuân đường|xuan duong
long giao
thừa đức|thua duc
bảo bình|bao binh
xuân bảo|xuan bao
xuân tây|xuan tay
xuân đông|xuan dong
sông ray|song ray
lâm san|lam san
long đức|long duc
cẩm đường|cam duong
long an
gia ray
suối cao|suoi cao
xuân tâm|xuan tam
xuân hiệp|xuan hiep
xuân định|xuan dinh
bảo hoà|bao hoa
lang minh
phước thiền|phuoc thien
đại phước|dai phuoc
hiệp phước|hiep phuoc
phú hữu|phu huu
long thọ|long tho
vĩnh thanh|vinh thanh
phước khánh|phuoc khanh
thắng tam|thang tam
thắng nhì|thang nhi
nguyễn an ninh|nguyen an ninh
thắng nhất|thang nhat
rạch dừa|rach dua
phước nguyên|phuoc nguyen
long toàn|long toan
long tâm|long tam
long hương|long huong
kim dinh
hoà long|hoa long
bàu chinh|bau chinh
ngãi giao|ngai giao
bình ba|binh ba
suối nghệ|suoi nghe
bình giã|binh gia
xà bang|xa bang
cù bị|cu bi
láng lớn|lang lon
suối rao|suoi rao
đá bạc|da bac
phước bửu|phuoc buu
xuyên mộc|xuyen moc
bông trang|bong trang
bàu lâm|bau lam
hòa hưng|hoa hung
bưng riềng|bung rieng
long điền|long dien
an ngãi|an ngai
an nhứt|an nhut
phước tỉnh|phuoc tinh
đất đỏ|dat do
phước long thọ|phuoc long tho
long mỹ|long my
láng dài|lang dai
mỹ xuân|my xuan
sông xoài|song xoai
hắc dịch|hac dich
châu pha|chau pha
tóc tiên|toc tien
đa kao|da kao|dakao
bến nghé|ben nghe
bến thành|ben thanh
nguyễn thái bình|nguyen thai binh
cầu ông lãnh|cau ong lanh
cô giang|co giang
nguyễn cư trinh|nguyen cu trinh
cầu kho|cau kho
thạnh xuân|thanh xuan
thạnh lộc|thanh loc
thới an|thoi an
tân chánh hiệp|tan chanh hiep
an phú đông|an phu dong
tân thới hiệp|tan thoi hiep
trung mỹ tây|trung my tay
tân hưng thuận|tan hung thuan
đông hưng thuận|dong hung thuan
tân thới nhất|tan thoi nhat
linh xuân|linh xuan
bình chiểu|binh chieu
linh trung
tam bình|tam binh
hiệp bình phước|hiep binh phuoc
hiệp bình chánh|hiep binh chanh
linh chiểu|linh chieu
linh tây|linh tay
linh đông|linh dong
bình thọ|binh tho
long thạnh mỹ|long thanh my
hiệp phú|hiep phu
tăng nhơn phú a|tang nhon phu a
tăng nhơn phú b|tang nhon phu b
phước long b|phuoc long b
phước long a|phuoc long a
trường thạnh|truong thanh
long trường|long truong
phường 15|phuong 15|p.15|p. 15|p15|p 15
phường 13|phuong 13|p.13|p. 13|p13|p 13
phường 17|phuong 17|p.17|p. 17|p17|p 17
phường 16|phuong 16|p.16|p. 16|p16|p 16
phường 14|phuong 14|p.14|p. 14|p14|p 14
phường 05|phuong 05|p.05|p. 05|p05|p 05
phường 07|phuong 07|p.07|p. 07|p07|p 07
phường 04|phuong 04|p.04|p. 04|p04|p 04
phường 01|phuong 01|p.01|p. 01|p01|p 01
phường 03|phuong 03|p.03|p. 03|p03|p 03
phường 27|phuong 27|p.27|p. 27|p27|p 27
phường 26|phuong 26|p.26|p. 26|p26|p 26
phường 25|phuong 25|p.25|p. 25|p25|p 25
phường 24|phuong 24|p.24|p. 24|p24|p 24
phường 06|phuong 06|p.06|p. 06|p06|p 06
phường 02|phuong 02|p.02|p. 02|p02|p 02
phường 21|phuong 21|p.21|p. 21|p21|p 21
phường 22|phuong 22|p.22|p. 22|p22|p 22
phường 19|phuong 19|p.19|p. 19|p19|p 19
phường 28|phuong 28|p.28|p. 28|p28|p 28
phường 08|phuong 08|p.08|p. 08|p08|p 08
phường 09|phuong 09|p.09|p. 09|p09|p 09
tân sơn nhì|tan son nhi
tây thạnh|tay thanh
tân quý|tan quy
phú thọ hòa|phu tho hoa
tân thới hòa|tan thoi hoa
thảo điền|thao dien
bình trưng đông|binh trung dong
bình trưng tây|binh trung tay
cát lái|cat lai
thạnh mỹ lợi|thanh my loi
an lợi đông|an loi dong
thủ thiêm|thu thiem
võ thị sáu|vo thi sau
phường 18|phuong 18|p.18|p. 18|p18|p 18
bình hưng hòa|binh hung hoa
bình hưng hoà a|binh hung hoa a
bình hưng hoà b|binh hung hoa b
bình trị đông|binh tri dong
bình trị đông a|binh tri dong a
bình trị đông b|binh tri dong b
tân tạo|tan tao
tân tạo a|tan tao a
an lạc a|an lac a
tân thuận đông|tan thuan dong
tân thuận tây|tan thuan tay
tân kiểng|tan kieng
tân quy|tan quy
củ chi|cu chi
phú mỹ hưng|phu my hung
trung lập thượng|trung lap thuong
an nhơn tây|an nhon tay
nhuận đức|nhuan duc
phạm văn cội|pham van coi
phú hòa đông|phu hoa dong
trung lập hạ|trung lap ha
tân an hội|tan an hoi
phước vĩnh an|phuoc vinh an
thái mỹ|thai my
tân thạnh tây|tan thanh tay
tân thạnh đông|tan thanh dong
tân phú trung|tan phu trung
tân thông hội|tan thong hoi
hóc môn|hoc mon
nhị bình|nhi binh
đông thạnh|dong thanh
tân thới nhì|tan thoi nhi
thới tam thôn|thoi tam thon
xuân thới sơn|xuan thoi son
xuân thới đông|xuan thoi dong
trung chánh|trung chanh
xuân thới thượng|xuan thoi thuong
bà điểm|ba diem
tân túc|tan tuc
phạm văn hai|pham van hai
vĩnh lộc a|vinh loc a
vĩnh lộc b|vinh loc b
lê minh xuân|le minh xuan
tân nhựt|tan nhut
tân kiên|tan kien
an phú tây|an phu tay
đa phước|da phuoc
tân quý tây|tan quy tay
quy đức|quy duc
nhà bè|nha be
phước kiển|phuoc kien
nhơn đức|nhon duc
long thới|long thoi
cần thạnh|can thanh
bình khánh|binh khanh
tam thôn hiệp|tam thon hiep
an thới đông|an thoi dong
thạnh an|thanh an
long hòa|long hoa
lý nhơn|ly nhon
hướng thọ phú|huong tho phu
nhơn thạnh trung|nhon thanh trung
lợi bình nhơn|loi binh nhon
bình tâm|binh tam
khánh hậu|khanh hau
an vĩnh ngãi|an vinh ngai
hưng điền b|hung dien b
hưng điền|hung dien
thạnh hưng|thanh hung
hưng thạnh|hung thanh
vĩnh châu b|vinh chau b
vĩnh đại|vinh dai
vĩnh châu a|vinh chau a
vĩnh bửu|vinh buu
hưng điền a|hung dien a
khánh hưng|khanh hung
thái trị|thai tri
vĩnh trị|vinh tri
thái bình trung|thai binh trung
vĩnh bình|vinh binh
tuyên bình|tuyen binh
tuyên bình tây|tuyen binh tay
thạnh trị|thanh tri
bình hòa tây|binh hoa tay
tuyên thạnh|tuyen thanh
bình hòa trung|binh hoa trung
bình hòa đông|binh hoa dong
bình phong thạnh|binh phong thanh
bắc hòa|bac hoa
hậu thạnh tây|hau thanh tay
nhơn hòa lập|nhon hoa lap
hậu thạnh đông|hau thanh dong
kiến bình|kien binh
nhơn ninh|nhon ninh
thạnh hóa|thanh hoa
thuận bình|thuan binh
thuận nghĩa hòa|thuan nghia hoa
thủy đông|thuy dong
thủy tây|thuy tay
tân tây|tan tay
mỹ quý đông|my quy dong
mỹ thạnh bắc|my thanh bac
mỹ quý tây|my quy tay
mỹ thạnh tây|my thanh tay
mỹ thạnh đông|my thanh dong
bình hòa bắc|binh hoa bac
bình hòa hưng|binh hoa hung
bình hòa nam|binh hoa nam
hậu nghĩa|hau nghia
lộc giang|loc giang
đức lập thượng|duc lap thuong
đức lập hạ|duc lap ha
mỹ hạnh bắc|my hanh bac
đức hòa thượng|duc hoa thuong
hòa khánh tây|hoa khanh tay
hòa khánh đông|hoa khanh dong
mỹ hạnh nam|my hanh nam
đức hòa đông|duc hoa dong
đức hòa hạ|duc hoa ha
hựu thạnh|huu thanh
bến lức|ben luc
thạnh lợi|thanh loi
lương bình|luong binh
thạnh hòa|thanh hoa
lương hòa|luong hoa
tân bửu|tan buu
bình đức|binh duc
phước lợi|phuoc loi
nhựt chánh|nhut chanh
thủ thừa|thu thua
long thạnh|long thanh
mỹ lạc|my lac
nhị thành|nhi thanh
mỹ phú|my phu
tân trụ|tan tru
quê mỹ thạnh|que my thanh
lạc tấn|lac tan
bình trinh đông|binh trinh dong
tân phước tây|tan phuoc tay
bình lãng|binh lang
bình tịnh|binh tinh
nhựt ninh|nhut ninh
cần đước|can duoc
long trạch|long trach
long khê|long khe
long định|long dinh
phước vân|phuoc van
long cang
mỹ lệ|my le
tân lân|tan lan
phước tuy|phuoc tuy
long hựu đông|long huu dong
tân ân|tan an
long hựu tây|long huu tay
tân chánh|tan chanh
cần giuộc|can giuoc
phước lý|phuoc ly
long thượng|long thuong
long hậu|long hau
phước lại|phuoc lai
phước lâm|phuoc lam
phước vĩnh tây|phuoc vinh tay
phước vĩnh đông|phuoc vinh dong
long phụng|long phung
tân tập|tan tap
tầm vu|tam vu
bình quới|binh quoi
phú ngãi trị|phu ngai tri
vĩnh công|vinh cong
thuận mỹ|thuan my
phước tân hưng|phuoc tan hung
thanh phú long|thanh phu long
dương xuân hội|duong xuan hoi
an lục long|an luc long
long trì|long tri
thanh vĩnh đông|thanh vinh dong
đạo thạnh|dao thanh
tân mỹ chánh|tan my chanh
long chánh|long chanh
tân hòa đông|tan hoa dong
thạnh hoà|thanh hoa
tân hòa thành|tan hoa thanh
tân lập 1|tan lap 1
tân hòa tây|tan hoa tay
tân lập 2|tan lap 2
phước lập|phuoc lap
cái bè|cai be
hậu mỹ bắc b|hau my bac b
hậu mỹ bắc a|hau my bac a
hậu mỹ trinh|hau my trinh
hậu mỹ phú|hau my phu
mỹ lợi b|my loi b
thiện trung|thien trung
mỹ hội|my hoi
mỹ lợi a|my loi a
thiện trí|thien tri
mỹ đức đông|my duc dong
mỹ đức tây|my duc tay
đông hòa hiệp|dong hoa hiep
an thái đông|an thai dong
an thái trung|an thai trung
an hữu|an huu
mỹ thành bắc|my thanh bac
mỹ phước tây|my phuoc tay
mỹ hạnh đông|my hanh dong
mỹ hạnh trung|my hanh trung
mỹ thành nam|my thanh nam
nhị mỹ|nhi my
nhị quý|nhi quy
phú quý|phu quy
mỹ long|my long
long tiên|long tien
hiệp đức|hiep duc
long trung
hội xuân|hoi xuan
tân hội đông|tan hoi dong
tân lý đông|tan ly dong
tân lý tây|tan ly tay
thân cửu nghĩa|than cuu nghia
điềm hy|diem hy
dưỡng điềm|duong diem
hữu đạo|huu dao
bình trưng|binh trung
bàn long|ban long
song thuận|song thuan
thới sơn|thoi son
chợ gạo|cho gao
hòa tịnh|hoa tinh
mỹ tịnh an|my tinh an
tân bình thạnh|tan binh thanh
phú kiết|phu kiet
lương hòa lạc|luong hoa lac
quơn long|quon long
bình phục nhứt|binh phuc nhut
đăng hưng phước|dang hung phuoc
tân thuận bình|tan thuan binh
song bình|song binh
bình phan|binh phan
long bình điền|long binh dien
an thạnh thủy|an thanh thuy
hòa định|hoa dinh
bình ninh|binh ninh
đồng thạnh|dong thanh
bình nhì|binh nhi
yên luông|yen luong
thạnh nhựt|thanh nhut
vĩnh hựu|vinh huu
tân thới|tan thoi
tăng hoà|tang hoa
gia thuận|gia thuan
bình xuân|binh xuan
vàm láng|vam lang
kiểng phước|kieng phuoc
bình ân|binh an
tân điền|tan dien
bình nghị|binh nghi
phú khương|phu khuong
an hội|an hoi
phú hưng|phu hung
mỹ thạnh an|my thanh an
nhơn thạnh|nhon thanh
tân thạch|tan thach
qưới sơn|quoi son
phú an hòa|phu an hoa
thành triệu|thanh trieu
tường đa|tuong da
quới thành|quoi thanh
an hóa|an hoa
tiên long|tien long
hữu định|huu dinh
tiên thủy|tien thuy
sơn hòa|son hoa
chợ lách|cho lach
phú phụng|phu phung
hòa nghĩa|hoa nghia
tân thiềng|tan thieng
hưng khánh trung b|hung khanh trung b
hưng khánh trung a|hung khanh trung a
mỏ cày|mo cay
thạnh ngãi|thanh ngai
tân phú tây|tan phu tay
phước mỹ trung|phuoc my trung
tân thành bình|tan thanh binh
tân thanh tây|tan thanh tay
định thủy|dinh thuy
nhuận phú tân|nhuan phu tan
đa phước hội|da phuoc hoi
khánh thạnh tân|khanh thanh tan
thành thới b|thanh thoi b
an thới|an thoi
thành thới a|thanh thoi a
ngãi đăng|ngai dang
hương mỹ|huong my
giồng trôm|giong trom
châu hòa|chau hoa
lương quới|luong quoi
thuận điền|thuan dien
bình hoà|binh hoa
hưng phong|hung phong
tân hào|tan hao
tân lợi thạnh|tan loi thanh
thạnh phú đông|thanh phu dong
hưng nhượng|hung nhuong
hưng lễ|hung le
bình đại|binh dai
vang quới tây|vang quoi tay
vang quới đông|vang quoi dong
châu hưng|chau hung
phú vang|phu vang
thới lai|thoi lai
bình thới|binh thoi
đại hòa lộc|dai hoa loc
thới thuận|thoi thuan
ba tri
bảo thạnh|bao thanh
an phú trung|an phu trung
mỹ nhơn|my nhon
phước ngãi|phuoc ngai
an ngãi trung|an ngai trung
phú lễ|phu le
an bình tây|an binh tay
an ngãi tây|an ngai tay
an hòa tây|an hoa tay
đại điền|dai dien
quới điền|quoi dien
thới thạnh|thoi thanh
an thuận|an thuan
an quy
thạnh hải|thanh hai
giao thạnh|giao thanh
thạnh phong|thanh phong
càng long|cang long
mỹ cẩm|my cam
an trường a|an truong a
an trường|an truong
huyền hội|huyen hoi
phương thạnh|phuong thanh
nhị long phú|nhi long phu
nhị long|nhi long
đức mỹ|duc my
cầu kè|cau ke
hòa ân|hoa an
châu điền|chau dien
an phú tân|an phu tan
hoà tân|hoa tan
ninh thới|ninh thoi
phong thạnh|phong thanh
tam ngãi|tam ngai
thông hòa|thong hoa
tiểu cần|tieu can
cầu quan|cau quan
hiếu tử|hieu tu
hiếu trung|hieu trung
hùng hòa|hung hoa
tân hùng|tan hung
tập ngãi|tap ngai
ngãi hùng|ngai hung
lương hoà a|luong hoa a
song lộc|song loc
nguyệt hóa|nguyet hoa
phước hảo|phuoc hao
cầu ngang|cau ngang
mỹ long bắc|my long bac
mỹ long nam|my long nam
kim hòa|kim hoa
nhị trường|nhi truong
hiệp mỹ đông|hiep my dong
hiệp mỹ tây|hiep my tay
thạnh hòa sơn|thanh hoa son
trà cú|tra cu
tập sơn|tap son
an quảng hữu|an quang huu
lưu nghiệp anh|luu nghiep anh
ngãi xuyên|ngai xuyen
hàm giang|ham giang
hàm tân|ham tan
đôn xuân|don xuan
đôn châu|don chau
ngọc biên|ngoc bien
long hữu|long huu
dân thành|dan thanh
trường long hòa|truong long hoa
ngũ lạc|ngu lac
tân ngãi|tan ngai
long hồ|long ho
bình hòa phước|binh hoa phuoc
phú quới|phu quoi
thạnh quới|thanh quoi
cái nhum|cai nhum
chánh an|chanh an
tân long hội|tan long hoi
vũng liêm|vung liem
tân quới trung|tan quoi trung
quới thiện|quoi thien
quới an|quoi an
tân an luông|tan an luong
trung thành tây|trung thanh tay
trung hiệp|trung hiep
hiếu phụng|hieu phung
trung thành đông|trung thanh dong
trung hiếu|trung hieu
trung ngãi|trung ngai
hiếu thuận|hieu thuan
hiếu nhơn|hieu nhon
hiếu thành|hieu thanh
hiếu nghĩa|hieu nghia
hoà lộc|hoa loc
song phú|song phu
long phú|long phu
mỹ thạnh trung|my thanh trung
tường lộc|tuong loc
loan mỹ|loan my
ngãi tứ|ngai tu
cái vồn|cai von
thành phước|thanh phuoc
thành trung|thanh trung
tân an thạnh|tan an thanh
tân lược|tan luoc
nguyễn văn thảnh|nguyen van thanh
tân quới|tan quoi
đông bình|dong binh
đông thuận|dong thuan
trà ôn|tra on
trà côn|tra con
hựu thành|huu thanh
vĩnh xuân|vinh xuan
thuận thới|thuan thoi
thiện mỹ|thien my
lục sỹ thành|luc sy thanh
tích thiện|tich thien
mỹ ngãi|my ngai
mỹ trà|my tra
tịnh thới|tinh thoi
tân khánh đông|tan khanh dong
tân quy đông|tan quy dong
tân quy tây|tan quy tay
tân phú đông|tan phu dong
sa rài|sa rai
tân hộ cơ|tan ho co
thông bình|thong binh
tân thành a|tan thanh a
tân thành b|tan thanh b
tân công chí|tan cong chi
thường phước 1|thuong phuoc 1
thường thới hậu a|thuong thoi hau a
thường thới tiền|thuong thoi tien
thường phước 2|thuong phuoc 2
thường lạc|thuong lac
long khánh a|long khanh a
long khánh b|long khanh b
an bình b|an binh b
an bình a|an binh a
phú thuận b|phu thuan b
phú thuận a|phu thuan a
tràm chim|tram chim
tân công sính|tan cong sinh
phú hiệp|phu hiep
phú thành b|phu thanh b
phú ninh|phu ninh
phú thành a|phu thanh a
tân kiều|tan kieu
mỹ quý|my quy
đốc binh kiều|doc binh kieu
láng biển|lang bien
gáo giồng|gao giong
phương thịnh|phuong thinh
phương trà|phuong tra
tân hội trung|tan hoi trung
bình hàng trung|binh hang trung
mỹ xương|my xuong
bình hàng tây|binh hang tay
an phong
bình tấn|binh tan
tân huề|tan hue
lấp vò|lap vo
mỹ an hưng a|my an hung a
mỹ an hưng b|my an hung b
tân khánh trung|tan khanh trung
long hưng a|long hung a
long hưng b|long hung b
định yên|dinh yen
hội an đông|hoi an dong
bình thạnh trung|binh thanh trung
lai vung
long thắng|long thang
vĩnh thới|vinh thoi
cái tàu hạ|cai tau ha
tân nhuận đông|tan nhuan dong
an phú thuận|an phu thuan
phú hựu|phu huu
mỹ xuyên|my xuyen
mỹ thới|my thoi
mỹ khánh|my khanh
mỹ hoà hưng|my hoa hung
châu phú b|chau phu b
châu phú a|chau phu a
vĩnh mỹ|vinh my
núi sam|nui sam
vĩnh ngươn|vinh nguon
vĩnh tế|vinh te
vĩnh châu|vinh chau
quốc thái|quoc thai
vĩnh hậu|vinh hau
vĩnh hội đông|vinh hoi dong
vĩnh xương|vinh xuong
phú vĩnh|phu vinh
lê chánh|le chanh
chợ vàm|cho vam
hiệp xương|hiep xuong
bình thạnh đông|binh thanh dong
cái dầu|cai dau
ô long vỹ|o long vy
vĩnh thạnh trung|vinh thanh trung
thạnh mỹ tây|thanh my tay
bình thủy|binh thuy
đào hữu cảnh|dao huu canh
nhà bàng|nha bang
núi voi|nui voi
tịnh biên|tinh bien
văn giáo|van giao
an hảo|an hao
tri tôn|tri ton
ba chúc|ba chuc
lạc quới|lac quoi
lê trì|le tri
vĩnh gia|vinh gia
châu lăng|chau lang
lương phi|luong phi
lương an trà|luong an tra
tà đảnh|ta danh
núi tô|nui to
an tức|an tuc
tân tuyến|tan tuyen
ô lâm|o lam
cần đăng|can dang
vĩnh hanh|vinh hanh
hòa bình thạnh|hoa binh thanh
vĩnh nhuận|vinh nhuan
chợ mới|cho moi
mỹ luông|my luong
kiến an|kien an
mỹ hội đông|my hoi dong
long điền a|long dien a
tấn mỹ|tan my
long điền b|long dien b
long kiến|long kien
bình phước xuân|binh phuoc xuan
an thạnh trung|an thanh trung
hội an|hoi an
núi sập|nui sap
óc eo|oc eo
vĩnh trạch|vinh trach
vĩnh chánh|vinh chanh
định mỹ|dinh my
mỹ phú đông|my phu dong
vọng đông|vong dong
vĩnh khánh|vinh khanh
thoại giang|thoai giang
vọng thê|vong the
vĩnh thanh vân|vinh thanh van
rạch sỏi|rach soi
vĩnh thông|vinh thong
phi thông|phi thong
tô châu|to chau
đông hồ|dong ho
bình san|binh san
pháo đài|phao dai
thuận yên|thuan yen
kiên lương|kien luong
kiên bình|kien binh
vĩnh điều|vinh dieu
tân khánh hòa|tan khanh hoa
hòa điền|hoa dien
hòn nghệ|hon nghe
hòn đất|hon dat
nam thái sơn|nam thai son
mỹ hiệp sơn|my hiep son
sơn kiên|son kien
lình huỳnh|linh huynh
thổ sơn|tho son
tân hiệp b|tan hiep b
thạnh đông b|thanh dong b
tân hiệp a|tan hiep a
thạnh đông a|thanh dong a
mong thọ a|mong tho a
mong thọ b|mong tho b
mong thọ|mong tho
giục tượng|giuc tuong
vĩnh hòa hiệp|vinh hoa hiep
vĩnh hoà phú|vinh hoa phu
giồng riềng|giong rieng
bàn thạch|ban thach
bàn tân định|ban tan dinh
ngọc thành|ngoc thanh
ngọc chúc|ngoc chuc
ngọc thuận|ngoc thuan
hoà lợi|hoa loi
hoà an|hoa an
ngọc hoà|ngoc hoa
gò quao|go quao
vĩnh hòa hưng bắc|vinh hoa hung bac
thới quản|thoi quan
thủy liễu|thuy lieu
vĩnh hòa hưng nam|vinh hoa hung nam
vĩnh phước a|vinh phuoc a
vĩnh phước b|vinh phuoc b
vĩnh thắng|vinh thang
thứ ba|thu ba
tây yên|tay yen
tây yên a|tay yen a
nam yên|nam yen
nam thái a|nam thai a
đông thái|dong thai
thạnh yên|thanh yen
thạnh yên a|thanh yen a
thứ mười một|thu muoi mot
an minh bắc|an minh bac
đông hưng a|dong hung a
đông hưng b|dong hung b
vân khánh|van khanh
vân khánh đông|van khanh dong
vân khánh tây|van khanh tay
hoà chánh|hoa chanh
vĩnh bình bắc|vinh binh bac
vĩnh bình nam|vinh binh nam
phong đông|phong dong
dương đông|duong dong
cửa cạn|cua can
gành dầu|ganh dau
cửa dương|cua duong
dương tơ|duong to
bãi thơm|bai thom
thổ châu|tho chau
hòn tre|hon tre
lại sơn|lai son
nam du
cái khế|cai khe
thới bình|thoi binh
xuân khánh|xuan khanh
châu văn liêm|chau van liem
thới long|thoi long
phước thới|phuoc thoi
trường lạc|truong lac
trà an|tra an
trà nóc|tra noc
thới an đông|thoi an dong
bùi hữu nghĩa|bui huu nghia
long tuyền|long tuyen
lê bình|le binh
hưng phú|hung phu
ba láng|ba lang
thường thạnh|thuong thanh
thốt nốt|thot not
trung nhứt|trung nhut
trung thạnh|trung thanh
thuận hưng|thuan hung
vĩnh trinh|vinh trinh
thạnh tiến|thanh tien
thạnh thắng|thanh thang
thạnh qưới|thanh quoi
cờ đỏ|co do
thới hưng|thoi hung
đông hiệp|dong hiep
đông thắng|dong thang
thới đông|thoi dong
thới xuân|thoi xuan
thới tân|thoi tan
trường thắng|truong thang
định môn|dinh mon
trường xuân a|truong xuan a
trường xuân b|truong xuan b
nhơn ái|nhon ai
trường long|truong long
nhơn nghĩa|nhon nghia
vị tân|vi tan
hoả lựu|hoa luu
hoả tiến|hoa tien
ngã bảy|nga bay
lái hiếu|lai hieu
một ngàn|mot ngan
hiệp lợi|hiep loi
bảy ngàn|bay ngan
trường long tây|truong long tay
trường long a|truong long a
nhơn nghĩa a|nhon nghia a
rạch gòi|rach goi
cái tắc|cai tac
tân phú thạnh|tan phu thanh
ngã sáu|nga sau
mái dầm|mai dam
đông phước|dong phuoc
đông phước a|dong phuoc a
kinh cùng|kinh cung
cây dương|cay duong
phụng hiệp|phung hiep
hòa mỹ|hoa my
phương bình|phuong binh
hiệp hưng|hiep hung
tân phước hưng|tan phuoc hung
búng tàu|bung tau
phương phú|phuong phu
nàng mau|nang mau
vị trung|vi trung
vị thuỷ|vi thuy
vị thắng|vi thang
vĩnh thuận tây|vinh thuan tay
vị đông|vi dong
vị thanh|vi thanh
vị bình|vi binh
trà lồng|tra long
long trị|long tri
long trị a|long tri a
vĩnh thuận đông|vinh thuan dong
vĩnh viễn|vinh vien
vĩnh viễn a|vinh vien a
lương tâm|luong tam
lương nghĩa|luong nghia
xà phiên|xa phien
kế sách|ke sach
an lạc thôn|an lac thon
an lạc tây|an lac tay
trinh phú|trinh phu
ba trinh
thới an hội|thoi an hoi
kế thành|ke thanh
kế an|ke an
đại hải|dai hai
huỳnh hữu nghĩa|huynh huu nghia
hồ đắc kiện|ho dac kien
phú tâm|phu tam
mỹ tú|my tu
cù lao dung|cu lao dung
an thạnh 1|an thanh 1
an thạnh tây|an thanh tay
an thạnh đông|an thanh dong
đại ân 1|dai an 1
an thạnh 2|an thanh 2
an thạnh 3|an thanh 3
an thạnh nam|an thanh nam
song phụng|song phung
đại ngãi|dai ngai
hậu thạnh|hau thanh
trường khánh|truong khanh
châu khánh|chau khanh
đại ân 2|dai an 2
trần đề|tran de
liêu tú|lieu tu
lịch hội thượng|lich hoi thuong
trung bình|trung binh
tài văn|tai van
đại tâm|dai tam
tham đôn|tham don
thạnh thới an|thanh thoi an
thạnh thới thuận|thanh thoi thuan
viên bình|vien binh
ngọc đông|ngoc dong
hòa tú 1|hoa tu 1
gia hòa 1|gia hoa 1
ngọc tố|ngoc to
gia hòa 2|gia hoa 2
hòa tú ii|hoa tu ii
vĩnh quới|vinh quoi
mỹ quới|my quoi
lâm tân|lam tan
lâm kiết|lam kiet
tuân tức|tuan tuc
lạc hòa|lac hoa
lai hòa|lai hoa
nhà mát|nha mat
vĩnh trạch đông|vinh trach dong
ngan dừa|ngan dua
ninh quới|ninh quoi
ninh quới a|ninh quoi a
ninh thạnh lợi a|ninh thanh loi a
ninh thạnh lợi|ninh thanh loi
vĩnh phú đông|vinh phu dong
vĩnh phú tây|vinh phu tay
phong thạnh tây a|phong thanh tay a
phong thạnh tây b|phong thanh tay b
vĩnh hưng a|vinh hung a
châu hưng a|chau hung a
hưng hội|hung hoi
châu thới|chau thoi
minh diệu|minh dieu
vĩnh mỹ b|vinh my b
vĩnh hậu a|vinh hau a
vĩnh mỹ a|vinh my a
hộ phòng|ho phong
phong thạnh đông|phong thanh dong
láng tròn|lang tron
phong tân|phong tan
phong thạnh a|phong thanh a
phong thạnh tây|phong thanh tay
gành hào|ganh hao
long điền đông|long dien dong
long điền đông a|long dien dong a
long điền tây|long dien tay
an trạch|an trach
an trạch a|an trach a
an phúc|an phuc
định thành a|dinh thanh a
tân xuyên|tan xuyen
an xuyên|an xuyen
tắc vân|tac van
lý văn lâm|ly van lam
u minh
khánh thuận|khanh thuan
khánh tiến|khanh tien
nguyễn phích|nguyen phich
khánh lâm|khanh lam
biển bạch|bien bach
tân bằng|tan bang
trí phải|tri phai
trí lực|tri luc
biển bạch đông|bien bach dong
tân lộc bắc|tan loc bac
tân lộc đông|tan loc dong
hồ thị kỷ|ho thi ky
trần văn thời|tran van thoi
sông đốc|song doc
khánh bình tây bắc|khanh binh tay bac
khánh bình tây|khanh binh tay
trần hợi|tran hoi
khánh lộc|khanh loc
khánh bình đông|khanh binh dong
lợi an|loi an
phong lạc|phong lac
cái nước|cai nuoc
lương thế trân|luong the tran
hoà mỹ|hoa my
đông thới|dong thoi
tân hưng đông|tan hung dong
trần thới|tran thoi
đầm dơi|dam doi
tạ an khương|ta an khuong
tạ an khương đông|ta an khuong dong
trần phán|tran phan
tạ an khương nam|ta an khuong nam
tân duyệt|tan duyet
quách phẩm bắc|quach pham bac
quách phẩm|quach pham
ngọc chánh|ngoc chanh
nguyễn huân|nguyen huan
năm căn|nam can
hiệp tùng|hiep tung
đất mới|dat moi
lâm hải|lam hai
hàng vịnh|hang vinh
tam giang đông|tam giang dong
cái đôi vàm|cai doi vam
việt thắng|viet thang
tân hưng tây|tan hung tay
rạch chèo|rach cheo
nguyễn việt khái|nguyen viet khai
tam giang tây|tam giang tay
tân ân tây|tan an tay
viên an đông|vien an dong
rạch gốc|rach goc
đất mũi|dat mui