cao đẳng|cao dang|cd|c d
câu lạc bộ |cau lac bo|clb|c l b
công ty cổ phần|cong ty co phan|ctcp|c t c p|cty cp|cty c p
công ty|cong ty|cty
công viên văn hóa|cong vien van hoa|cvvh|c v v h
công viên|cong vien|cv|c v
công viên hồ điều hoà
căn cứ không quân|can cu khong quan|cckq|c c k q
đại học|dai hoc|dh|d h|trường đại học|truong dai hoc
học viện|hoc vien
đường sắt|duong sat|ds|d s
khu công nghiệp|khu cong nghiep|kcn|k c n
khu kinh tế|khu kinh te
khu du lịch|khu du lich|kdl|k d l
khu dân cư|khu dan cư|khu dan cu
khu dân dụng
khu căn hộ|khu căn hộ cao tầng|cao ốc căn hộ|căn hộ|khu nhà ở di dân
khu nhà ở
khu đô thị|khu đô thị mới|khu đô thị mới phía
khu dịch vụ cao cấp
khu phố
phố đi bộ
nhà ga|ga
siêu thị
khu nghỉ mát|khu nghi mat|knm|k n m
khách sạn|khach san|ks
nhà hát|nha hat|nh|n h
nhà thi đấu|nha thi dau|ntd|n t d
nhà thờ|nha tho|nt|n t
phi trường|phi trong|pt|p t
rạp hát|rap hat|rh|r h
sân bay quốc tế|san bay quoc te|sbqt|s b q t
sân bay|san bay|sb|s b
sân vận động|san van dong|svd|s v d
tiểu học|tieu hoc|th|t h
trung học cơ sở|trung hoc co so|thcs|t h c s
trung học phổ thông|trung hoc pho thong|thpt|t h p t
khu trung tâm thương mại|trung tâm thương mại|trung tam thuong mai|tttm|t t t m|trung tâm tm|tòa nhà trung tâm thương mại|khu thương mại|khu trung tâm mua sắm
cao ốc căn hộ thương mại 
trung tâm|trung tam|tt|t t
toà|toà nhà|tòa nhà
tầng hầm
bến
cao ốc
tổng công ty|tong cong ty|tcty|tct
viện bảo tàng|vien bao tang|bảo tàng|vbt|v b t
vườn quốc gia|vuon quoc gia|vqg|v q g
chợ
chùa
dinh
chung cư|tòa nhà chung cư
bệnh viện
vincom|vinhome|vinhomes|winmart|vinmart|vincity|vinpearl|vinfast|vinmec|vinschool|vineco|aeon|lotte
khu công
khu tập thể
công an|cong an
ủy ban nhân dân|uy ban nhan dan|ubnd
nhà máy
nhà thuốc
vòng xoay ngã tư
nhà thiếu nhi
cảng hàng không