ái|ai
an
anh
ao
ánh|anh
ân
âu|au
âu
dương
ấu
bá|ba
bạc|bac
bạch|bach
bàn|ban
bàng|bang
bành|banh
bảo|bao
bế|be
bì|bi
biện|bien
bình|binh
bồ|bo
chriêng|chrieng
ca|ca
cà
cái|cai
cai
cam
cảnh|canh
cao|cao
cáp|cap
cát|cat
cầm
cấn|can
chế|che
chiêm|chiem
châu|chau
chu
chắng|chang
chúng
chương|chuong
chử
cồ|co
cổ
cống
cung|cung
cù|cu
cự
dã|da
danh|danh
diêm|diem
diệp|diep
doãn|doan
du
duy
dư
đái|dai
đan|dan
đàm|dam
đào|dao
đăng|dang
đắc|dac
đầu|dau
đậu
đèo|deo
điêu|dieu
điền|dien
điều
đinh|dinh
đình
đoái|doai
đoàn|doan
đoạn
đôn|don
đống|dong
đồ|do
đồng|dong
đổng|dong
đới|đái|doi|dai
đương
đức|duc
giả|gia
giao|giao
giang|giang
giàng|giang
giản|gian
giảng|giang
giáp|giap
hưng|hung
h'|h 
h'ma|h ma
h'nia|h nia
hầu|hau
hà|ha
hạ|ha
hàn|han
hàng|hang
hán|han
hề|he
hi|hi
hình|hinh
hoa|hoa
hoà|hoa
hoài|hoai
hoàng|hoang
phủ|phu
hồng|hong
hùng|hung
hứa|hua
hướng|huong
kinh|kinh
kông|kong
kiểu|kieu
kha|kha
khà|kha
khai|khai
khâu|khau
khiếu|khieu
khoa|khoa
khổng|khong
khuất|khuat
khúc|khuc
khương|khuong
khưu|khuu
kiều|kieu
kim|kim
ly|ly
lý|ly
la|la
lã|lữ|la lu
lành|lanh
lãnh|lanh
lạc|lac
lại|lai
lăng|lang
lâm|lam
lầu|lau
lèng|leng
lều|leu
liên|lien
liệp|liep
liêu|lieu
liễu|lieu
linh|linh
loan|loan
lò
lỗ
lộ
lộc|loc
luyện|luyen
lục|luc
lư|lu
lương|luong
lường|luong
lưu|luu
ma|ma
mai|mai
mang|mang
mã|ma
mạc|mac
mạch|mach
mạnh|manh
mâu|mau
mầu|mau
mẫn|man
minh|minh
mộc|moc
mông|mong
mùa|mua
mục|muc
miêu|mieu
niê|nie
ngạc|ngac
ngân|ngan
nghiêm|nghiem
nghị|nghi
ngọ|ngo
ngọc|ngoc
ngôn|ngon
ngũ|ngu
ngụy|nguy
nhan|nhan
nhâm|nham
nhữ|nhu
ninh|ninh
nông|nong
ong|ong
ông|ong
phi|phi
phí|phi
phó|pho
phong|phong
phù|phu
phú|phu
phùng|phung
phương|phuong
quản|quan
quán|quan
quang|quang
quàng|quang
quảng|quang
quách|quach
quế|que
quốc|quoc
quyền|quyen
sái|sai
sâm|sam
sầm|sam
sơn|son
sử|
sư
sùng|sung
sỳ|sy
tán|tan
tào|tao
tạ|ta
tăng|tang
tấn|tan
tất|tat
tề|te
thang|thang
thanh|thanh
thái|thai
thành|thanh
thào|thao
thạch|thach
thân|than
thẩm|tham
thập|thap
thế
thi|thi
thiều|thieu
thiệu|thieu
thịnh|thinh
thiềm|thiem
thoa|thoa
thôi|thoi
thóng|thong
thục|thuc
tiêu|tieu
tiết|tiet
tiếp|tiep
tinh|tinh
tòng|tong
tô|to
tôn|ton
tôn|ton
nữ|nu
tôn|ton
thất|that
tông|tong
tống|tong
trang|trang
tráng|trang
trác|trac
trà|tra
trâu|trau
tri|tri
trì|tri
triệu|trieu
trình|trinh
trịnh|trinh
trung|trung
trưng|trung
tuấn|tuan
từ|tu
tưởng|tuong
tướng|tuong
ty|ty
uông|uong
ung|ung
ưng|ung
ứng|ung
vàng|vang
vâng|vang
vạn|van
văn|van
vi|vi
vĩnh|vinh
viêm|viem
việt|viet
vừ
vương|vuong
vưu|vuu
vu
xa
xung
yên|yen
nguyễn|nguyen
trương
trần|tran
lê|le
phạm|pham
hoàng|hoang
huỳnh|huynh
phan|phan
vũ|vu
võ|vo
đặng|dang
bùi|bui
đỗ|do
hồ|ho
ngô|ngo
dương
thuận
lý|ly