cách mạng tháng 8|cách mạng tháng tám|cmt8|cmt 8|cmt tám|cm tháng 8|cm tháng tám|cach mang thang 8|cach mang|cách mạng
hương lộ|huong lo
bến vân đồn|ben van don
út tịch|ut tich
vườn lài|vuon lai
nguyên hồng|nguyen hong
lũy bán bích|luy tan bich
gò xoài|go xoai
tên lửa|ten lua
tây lân|tay lan
hiệp bình|hiep binh
xô viết nghệ tĩnh|xvnt|xo viet nghe tinh
phố chờ|pho cho
ngô thì nhậm|ngo thi nham
langbiang
hải thượng lãn ông|hai thuong lan ong
triều dương|trieu duong
bời lời|boi loi
giải phóng|giai phong
royal city
bưng môn|bung mon
gò tháp|go thap
nam kỳ khởi nghĩa|nam ky khoi nghia
hoà hảo|hòa hảo|hoa hao
him lam tân hưng|him lam|him lam tan hung
thuốc bắc|thuoc bac
pasteur
cư xá|cu xa
đường thành|duong thanh
big c
nguyễn huệ a|nguyễn huệ b|nguyen hue a|nguyen hue b
bình than|binh than
hùng vương|hung vuong
tản đà|tan da
tạo lực 5|tao luc 5
xa lộ hà nội|xa lo ha noi
thoại ngọc hầu|thoai ngoc hau
tây ban nha|tay ban nha
kênh liêm|kenh liem
cứu hỏa|cuu hoa
co.opmart
hòn cặp bè|hon cap be
cửu long cư xá bắc hải|cuu long cu xa bac hai
kim văn kim lũ|kim van kim lu
điện biên phủ|dien bien phu
nam sông hậu|nam song hau
thửa đất số|thua dat so
trích sài|trich sai